abandon	抛弃，放弃	v. 
abandonment	放弃	n. 
abasement	滥用	n. 
abbreviation	缩写	n. 
abeyance	缓办，中止	n. 
abide	遵守	v. 
ability	能力	n. 
able	有能力的，能干的	adj. 
abnormal	反常的，变态的	adj. 
aboard	船(车)上	adv. 
abolish	废除，取消	v. 
abolition	废除，取消	n. 
abortion	流产	n. 
abortive	无效果的，失败的	adj. 
about	关于，大约	prep. 
above	在...之上，高于	prep. 
above-mentioned	上述的	adj. 
abreast	并肩，并列	adv. 
abridge	省略，摘要	v. 
abroad	国外，海外	adv. 
abrogate	取消，废除	v. 
abrogation	取消，废除	n. 
abrupt	突然的，生硬的	adj. 
abruptly	突然地	adv. 
absence	缺席，缺乏	n. 
absent	缺席的，不存在	adj. 
absent-minded	心不在焉的	adj. 
absolute	完全的，绝对的	adj. 
absolutely	绝对，完全	adv. 
absorb	吸收，专心于	v. 
absorption	吸收，专注	n. 
abstract	抽象的，难懂的	adj. 
abstraction	抽象，提取	n. 
absurd	荒唐的	adj. 
absurdity	荒唐(事)	n. 
abundance	丰富，大量	n. 
abundant	丰富的，充裕的	adj. 
abuse	滥用，谩骂	v. 
academic	学院的，学术的	adj. 
academy	学院，研究院	n. 
accede	同意	v. 
accelerate	加速，加快	v. 
acceleration	加速，促进	v. 
accent	腔调	n. 
accept	接受，同意	v. 
acceptable	可接受的，合意的	adj. 
acceptance	接受，承兑	n. 
access	接近，入口	n. 
accessible	可接近的	adj. 
accessory	附件，装饰品	n. 
accident	事故，意外之事	n. 
accidental	意外的，偶然的	adj. 
accidentally	偶尔，附带	adv. 
accommodate	提供便利，拆借	v. 
accommodation	便利，通融	n. 
accompaniment	伴侣，伴奏	n. 
accompany	伴随，伴奏	v. 
accomplish	完成，达到	v. 
accomplishment	成就	n. 
accord	符合，协调	v. 
accordance	按照，与...一致	n. 
according	按照，据...说	adj. 
accordingly	相应地，从而	adj. 
account	账目	n. 
accountant	会计(师)	n. 
accounting	会计学	n. 
accrue	产生，发生	v. 
accrued	增值的，应计的	adj. 
accumulate	积累，积蓄	v. 
accumulation	积累	n. 
accumulative	积累的	adj. 
accuracy	准确(性)	n. 
accurate	准确的，精密的	adj. 
accurately	准确地	adj. 
accusation	控告	n. 
accuse	告发，指责	v. 
accustom	使...习惯于	v. 
ache	觉得疼	v. 
achieve	完成，实现	v. 
achievement	完成，成就	n. 
aching	疼痛的	adj. 
acid	酸	n. 
acknowledge	承认，鸣谢	v. 
acknowledgment	承认，鸣谢，回执	n. 
acquaint	使熟悉，相识	n. 
acquaintance	熟悉人，相识	n. 
acquaintant	熟悉的	adj. 
acquire	求得，获得	v. 
acquisition	获得	n. 
acre	英亩	n. 
acrobat	杂技演员	n. 
acrobatics	杂技	n. 
across	横越	prep. 
act	行为，法令	n. 
action	行为，行动	n. 
activate	使活跃，开动	v. 
active	活跃的，积极的	adj. 
actively	积极地，活跃地	adv. 
activity	活动	n. 
actor	男演员	n. 
actress	女演员	n. 
actual	现实的，实际的	adj. 
actuality	实际	n. 
actually	实际上，居然	adv. 
acute	剧烈的，敏锐的	adj. 
ad	(缩)广告	n. 
adapt	使适应，改编	v. 
adaptation	适应	n. 
add	增添，加，补充	v. 
addition	增加，附加物	n. 
additional	增加的，附加的	adj. 
additive	附加的	adj. 
address	地址	n. 
adequate	足够的，恰当的	adj. 
adequately	恰当地	adv. 
adhere	粘附，坚持	v. 
adhesive	粘合剂	n. 
adjacent	邻近的	adj. 
adjective	形容词	n. 
adjoin	毗连	v. 
adjust	调整，修整	v. 
adjustable	可调整的	adj. 
adjustment	调整	n. 
administer	管理	v. 
administration	行政管理，管理机关	n. 
administrative	行政管理的	adj. 
admirable	可钦佩的	adj. 
admiration	羡慕，钦佩	n. 
admire	钦佩，赞美	v. 
admission	准入，承认	n. 
admit	承认，接纳	v. 
admittedly	明白地	adv. 
adolescence	青春期	n. 
adolescent	青春期的	adj. 
adopt	采用，采纳	v. 
adoption	采用	n. 
adore	崇拜，敬慕	v. 
adorn	装饰，佩带	v. 
adornment	装饰(品)	n. 
adult	成年人	n. 
advance	前进	n. v. 
advanced	先进的，发达的	adj. 
advantage	优点，优势	n. 
advantageous	有利的，有用的	adj. 
adventure	冒险，惊险活动	n. 
adventurous	冒险的	adj. 
adverb	副词	n. 
adverbial	副词的	adj. 
adversary	敌手，对手	adj. 
adverse	逆的，相反的	v. 
adversity	逆境，不幸	n. 
advertise	登广告，推销	v. 
advertisement	广告	n. 
advertising	广告的	adj. 
advice	忠告，意见	n. 
advisable	适当的，可行的	adj. 
advise	劝告，通知	v. 
adviser	顾问	n. 
advocate	拥护，提倡	v. 
aerial	天空的，航空的	adj. 
aeroplane	飞机	n. 
affair	事件，事情	n. 
affect	影响，改变	v. 
affection	友爱，爱慕	n. 
affectionate	充满感情的	adj. 
affiliate	分号(公司)	n. 
affirm	断言，肯定	v. 
affirmation	确定，确认	n. 
affirmative	肯定的	adj. 
afford	买得起，经受得起	v. 
affordable	买得起的	adj. 
afloat	航行中的	adj. 
aforesaid	上述的	adj. 
afraid	害怕的，恐怕	adj. 
africa	非洲	n. 
african	非洲的	adj. 
after	在...后	prep. 
afternoon	下午	n. 
afterward	后来	adv. 
again	再，又	adv. 
against	反对，对着	prep. 
age	年龄，时代	n. 
agency	代理，代理处	n. 
agent	代理人，试剂	n. 
aggravate	加重，恶化	v. 
aggravation	加重，恶化	n. 
aggregate	合计(的)	v. n. adj. 
aggregation	总计，集合	n. 
aggression	侵略	n. 
aggressive	侵略的，进取的	adj. 
aggressor	侵略者	n. 
agitate	鼓动	v. 
agitation	鼓动，不安	n. 
ago	以前	adv. 
agonize	使痛苦	v. 
agony	苦恼，痛苦	n. 
agree	同意，一致认为	v. 
agreeable	惬意的，易相处的	adj. 
agreeably	欣然，依照	adv. 
agreed	商定的	adj. 
agreement	一致，协议	n. 
agricultural	农业的	adj. 
agriculture	农业	n. 
ahead	在...前	adv. 
aid	援助，救护	n. v. 
aids	(缩)艾滋病	n. 
ailment	疾病	n. 
aim	目的	n. 
aimless	无目的的	adj. 
air	空气，气派	n. 
aircraft	航空器	n. 
airline	航线，航空公司	n. 
airliner	定期航班	n. 
airmail	航空邮件	n. 
airplane	飞机	n. 
airport	机场	n. 
airway	航线	n. 
aisle	过道，走廊	n. 
ajar	半开的	adv. 
alarm	惊慌，警报	n. 
alarming	警告的	adj. 
alas	唉，哎呀	int. 
album	相册，地图册	n. 
alcohol	酒精	n. 
alcoholic	含酒精的	adj. 
alcoholism	嗜酒者，酒鬼	n. 
ale	淡啤酒	n. 
alert	警惕的，灵活的	adj. 
algebra	代数	n. 
alien	异国的，异样的	adj. 
alienate	疏远，转让，挪用	v. 
alienation	异化	n. 
alignment	对准，准线	n. 
alike	相象的	adj. 
alive	活着的，有生命的	adj. 
all	所有的	adj. 
allergic	过敏的，变态的	adj. 
allergy	反感，过敏	n. 
alliance	联合，同盟	n. 
allied	同盟的	adj. 
allocate	分配	v. 
allocation	分配	n. 
allot	分配，配给	v. 
allotment	分配，份额	n. 
allow	允许，许可	v. 
allowance	补助，津贴	n. 
alloy	合金	n. 
ally	同盟者	n. 
almost	几乎，差不多	adv. 
alone	单独的，仅仅	adj. 
along	沿着	prep. 
alongside	在...旁边	prep. 
aloud	大声地	adv. 
alphabet	字母表	n. 
also	也	adv. 
alter	改变，变动	v. 
alternate	轮流，交替	v. 
alternation	改变，变更	n. 
alternative	两者取一	n. v. 
although	虽然	conj. 
altitude	高度	n. 
altogether	全部地，总共	adv. 
aluminum	铝	n. 
always	总是，始终	adv. 
amateur	业余的	adj. 
amaze	使惊叹	v. 
amazement	惊奇，诧异	n. 
ambassador	大使	n. 
ambient	周围的，包围着的	adj. 
ambiguity	歧义性，意义不明处	n. 
ambiguous	模棱两可的	adj. 
ambition	抱负，野心	n. 
ambitious	雄心勃勃的	adj. 
ambulance	救护车	n. 
amend	修改，更正	v. 
amendment	修改(通知书)	n. 
amends	赔偿	n. 
america	美国，美洲	n. 
american	美国的	adj. 
amiable	和蔼的，亲切的	adj. 
amicable	友好的，和睦的	adj. 
amid	在...之间	prep. 
ammunition	弹药	n. 
among	在...之中	prep. 
amount	数量，总数	n. 
ampere	【电】安培	n. 
ample	宽大的，充裕的	adj. 
amplification	放大	n. 
amplifier	放大器，扩音机	n. 
amplify	详述，放大	v. 
amuse	逗乐，给娱乐	v. 
amusement	娱乐，乐趣	n. 
analogue	模拟，类似物	n. 
analogy	类似，类推	n. 
analysis	分析，分解	n. 
analytical	分析的，解析的	adj. 
analyze	分析，分解	v. 
ancestor	祖先，祖宗	n. 
anchor	锚	n. 
ancient	古老的，古代的	adj. 
and	和，与，而	conj. 
anecdote	轶事，轶闻	n. 
angel	天命，安琪儿	n. 
anger	生气，愤怒	n. 
angle	角，角度	n. 
angry	生气的，愤怒的	adj. 
angular	角状的	adj. 
animal	动物	n. 
animate	使有活力，激活	v. 
animation	生气，生机	n. 
ankle	踝，踝骨	n. 
annex	附录，附件	n. 
anniversary	周年纪念日	n. 
announce	宣布，通报	v. 
announcement	通知	n. 
announcer	播音员	n. 
annoy	烦扰，使生气	v. 
annoyance	烦恼，麻烦事	n. 
annual	每年的，年度的	adj. 
annually	每年，年年	adv. 
another	另一个	pron. prep. 
answer	答案	n. 
ant	蚂蚁	n. 
antagonism	对立，敌对	n. 
antagonist	对手，敌手	n. 
antarctic	南极的	adj. 
antecedent	触角，天线	n. 
antibiotic	抗菌的	adj. 
anticipate	期望，预料	v. 
anticipation	期望，预料	n. 
antique	古老的	adj. 
antonym	反义词	n. 
antonymous	反义的	adj. 
anxiety	焦虑，担心	n. 
anxious	焦急的，切盼的	adj. 
anxiously	焦急地，急切地	adv. 
any	任何，一些	adj. 
anybody	任何人	pron. 
anyhow	无论如何	adv. 
anyone	无论谁	pron. 
anything	无论什么	pron. 
anyway	不管怎样	adv. 
anywhere	无论何地	adv. 
apart	分离，隔开	adv. 
apartment	套房，公寓	n. 
ape	猿猴	n. 
apologize	道歉	v. 
apology	道歉	n. 
apparatus	仪器，设备	n. 
apparent	明显的，表面上的	adj. 
apparently	显然，似乎	adj. 
appeal	呼吁，上诉	v. n. 
appealing	有吸引力的	adj. 
appear	出现，好象	v. 
appearance	出现，外表	n. 
appendix	附录，盲肠	n. 
appetite	食欲，欲望	n. 
applaud	称赞，拍手喝彩	v. 
applause	喝彩，欢呼	n. 
apple	苹果	n. 
appliance	用具，器械	n. 
applicable	生动的，适用的	adj. 
applicant	申请人	n. 
application	申请，应用	n. 
apply	应用，申请	v. 
appoint	任命，约定	v. 
appointment	任命，约会	n. 
appreciable	可看到的	adj. 
appreciably	相当大地	adv. 
appreciate	欣赏，感激	v. 
appreciation	欣赏，感激	n. 
appreciative	感激的	adj. 
apprentice	学校	n. 
apprize	通知	v. 
approach	接近	v. 
appropriate	恰当的	adj. 
approval	同意，批准	n. 
approve	赞成，批准	v. 
approximate	近似，约略	adj. v. 
approximately	近乎，大约	adv. 
approximation	近似值	n. 
april	四月	n. 
apt	恰当的，易于	adj. 
aptitude	才智，天资	n. 
arab	阿拉伯	n. 
arabian	阿拉伯人，阿拉伯语	n. 
arabic	阿拉伯的	adj. 
arbitrary	专横的，任意的	adj. 
arbitrate	仲裁	v. 
arbitration	仲裁	n. 
arbitrator	仲裁员	n. 
arc	弧	n. 
arch	拱门，弓形	n. 
archaeologist	考古学家	n. 
archaeology	考古学	n. 
architect	建筑师	n. 
architecture	建筑学	n. 
arctic	北极的	adj. 
ardent	热心的，强烈的	adj. 
arduous	艰巨的，努力的	adj. 
area	地区，面积，领域	n. 
arena	竞技场	n. 
argue	争论，辩论	v. 
argument	争论，论点	n. 
arise	起来，出现	v. 
aristocracy	贵族阶层	n. 
aristocrat	贵族	n. 
aristocratic	贵族的	adj. 
arithmetic	算术	n. 
arm	手臂，扶手	n. 
armchair	手扶椅	n. 
armour	盔甲，装甲	n. 
arms	武器	n. 
army	军队，陆军	n. 
around	在周围，大约	adv. 
arouse	唤醒，唤起	v. 
arrange	整理，安排	v. 
arrangement	安排，计划	n. 
array	装扮，排列	v. 
arrear	欠款	n. 
arrest	逮捕，吸引	v. 
arrival	到达，到货	n. 
arrive	到达，达到	v. 
arrogance	傲慢	n. 
arrogant	傲慢的	adj. 
arrogantly	傲慢地	adv. 
arrow	箭，箭头	n. 
art	艺术，技艺	n. 
article	文章，物品，冠词	n. 
artificial	人造的，假的	adj. 
artist	艺术家	n. 
artistic	艺术的	n. 
as	一样	adv. 
ascend	登，上升	v. 
ascertain	查明，弄清	v. 
ascribe	归于	v. 
asean	(缩)东盟	n. 
ash	灰，灰烬	n. 
ashamed	惭愧的，羞耻的	adj. 
ashore	在岸上，上岸	adv. 
ashtray	烟灰缸	n. 
asia	亚洲	n. 
asian	亚洲的	adj. 
aside	在旁边，搁在一边	adv. 
ask	问，要求，邀请	v. 
asleep	睡着的	adj. 
aspect	容貌，方面	n. 
aspirin	阿斯匹林	n. 
ass	驴，愚蠢的人	n. 
assassinate	暗杀	v. 
assassination	暗杀	n. 
assassinator	暗杀者	n. 
assault	袭击，攻击	v. 
assemble	集合，装配	v. 
assembly	集合，装配	n. 
assert	断言，宣称	v. 
assertion	断言	n. 
assess	评定，估价	v. 
assessment	估值，评价	n. 
assign	分配，指定	v. 
assignment	任务，作业	n. 
assist	协助	v. 
assistance	协助，辅助	n. 
assistant	助手	n. 
associate	联想	v. 
associated	联合的	adj. 
association	协会，合营	n. 
associative	联想的	adj. 
assorted	各种各样的	adj. 
assortment	花色品种	n. 
assume	假定，担任	v. 
assumption	假定，假装	n. 
assurance	自信，保证	n. 
assure	使...放心	v. 
assured	感到放心的	adj. 
astonish	使惊讶	v. 
astonishment	惊讶	n. 
astound	使惊讶	v. 
astray	(信件)遗失、误传	adv. 
astronaut	宇宙飞行员	n. 
astronomer	天文学家	n. 
astronomical	天文学的	adj. 
astronomy	天文学	n. 
at	在，处于，以	prep. 
athlete	田径运动员	n. 
athletic	田径的	adj. 
atlantic	大西洋(的)	n. adj. 
atlas	地图集	n. 
atmosphere	大气，气氛	n. 
atmospheric	大气的，空气的	adj. 
atom	原子，微粒	n. 
atomic	原子的，原子能的	adj. 
attach	附着于，依恋	v. 
attachment	依附，附件，爱慕	n. 
attack	进攻，侵袭	v. n. 
attain	赢得，到达	v. 
attempt	尝试，企图	v. n. 
attend	出席，照顾	v. 
attendance	出勤(率)，出席	n. 
attendant	随从，服务员	n. 
attention	注意，关心	n. 
attentive	注意的，关心的	adj. 
attentively	关心地	adv. 
attic	阁楼	n. 
attitude	态度，看法	n. 
attorney	辩护律师	n. 
attract	吸引，引力	v. 
attraction	有吸引力的	adj. 
attributable	归于...的	adj. 
attribute	属于	v. 
attribution	属于	n. 
attributive	定语的，属性的	adj. 
auction	拍卖	n. 
audience	听众，观众	n. 
auditorium	礼堂	n. 
august	八月	n. 
aunt	伯(婶、姨、姑)母	n. 
aural	听觉的，耳的	adj. 
auspice	赞助，主办	n. 
australia	澳大利亚	n. 
australian	澳大利亚的	adj. 
author	作者，创造者	n. 
authority	权力，权威	n. 
authorization	授权	n. 
authorize	授权，批准	v. 
autobiography	自传	n. 
automate	自动化	v. 
automatic	自动的	adj. 
automation	自动化	n. 
automobile	汽车	n. 
autonomous	自治的	adj. 
autonomy	自治	n. 
autumn	秋天	n. 
auxiliary	辅助的，补助的	adj. 
avail	帮助，有用	v. 
availability	可用性，可供货	n. 
available	可得到的	adj. 
avenge	报复	v. 
avenue	林荫道，途径	n. 
average	平均的	adj. 
averagely	平均	adv. 
aviation	航空	n. 
avoid	避免，逃避	v. 
await	等候，等待	v. 
awake	醒来,醒悟	v. 
awaken	醒着的	adj. 
award	授予	v. 
aware	知道的，意识到的	adj. 
away	去，远离，在远处	adv. 
awe	威惧	n. 
awesome	可怕的	adj. 
awful	令人畏惧的	adj. 
awfully	可怕地，非常	adv. 
awkward	笨拙的，不熟练的	adj. 
awkwardly	笨拙地	adv. 
awkwardness	笨拙	n. 
ax	斧子	n. 
axial	轴的，轴向的	adj. 
axis	轴，轴线，轴心	n. 
axle	(轮)轴	n. 
baby	婴儿，年龄最小的人	n. 
baby-sit	(替人)看护小孩	v. 
baby-sitter	看护小孩的人	n. 
bachelor	单身汉，学士	n. 
back	背	n. 
backbone	脊梁骨	n. 
backdate	回溯	v. 
background	背景，经历	n. 
backing	倒退，支持物	n. 
backlog	未交付的订货	n. 
backward	向后，逆	adv. 
backwardness	落后(状态)	n. 
bacon	咸肉，熏肉	n. 
bacterium	细菌	n. 
bad	坏的，低劣的	adj. 
badge	徽章	n. 
badly	坏，非常，严重地	adv. 
badminton	羽毛球	n. 
baffle	困扰，难倒	v. 
bag	袋子，提包	n. 
baggage	行李	n. 
baggy	袋状的	adj. 
bait	饵，诱饵	n. 
bake	烤，烘	v. 
baker	面包师	n. 
bakery	面包店	n. 
balance	平衡，天平，余额	n. 
balcony	阳台	n. 
bald	秃的	adj. 
ball	球，球状物，舞会	n. 
ballet	芭蕾舞	n. 
balloon	气球	n. 
ballooning	热气球飞行运动	n. 
ballroom	舞厅	n. 
bamboo	竹	n. 
bamboo-shoot	竹笋	n. 
banana	香蕉	n. 
band	乐队，带子	n. 
bandage	绷带	n. 
bandit	盗匪，歹徒	n. 
bang	砰的一响	n. v. 
bank	岸，银行	n. 
banker	银行家	n. 
banking	银行业务、金融业	n. 
bankrupt	破产	n. v. adj. 
banner	旗帜，横幅	n. 
banquet	宴会	n. 
bar	棒，杆，酒吧	n. 
barber	理发师	n. 
bare	裸的，直率的	adj. 
barely	赤裸裸地	adv. 
bargain	交易，便宜货	n. 
barge	驳船	n. 
bark	狗吠，树皮	n. 
barn	谷仓，牲口棚	n. 
barometer	晴雨表，标记	n. 
baron	男爵	n. 
baroness	男爵夫人，女男爵	n. 
barrel	桶，枪(炮)管	n. 
barren	不育的，贫瘠的	adj. 
barrier	障碍，壁垒	n. 
barter	易货贸易	n. 
base	基础，基地	n. 
baseball	棒球	n. 
basement	地下室，地窖	n. 
basic	基本的，基础的	adj. 
basically	基本上，主要地	adv. 
basin	盆，盆地	n. 
basis	基础，根据	n. 
basket	篮子，筐	n. 
basketball	篮球	n. 
bat	球拍，蝙蝠	n. 
bath	洗澡，浴室	n. 
bathe	洗澡，冲洗	v. 
bathroom	浴室，洗手间	n. 
batter	打击	v. 
battery	电池	n. 
battle	战斗，战役	n. 
bay	海湾，湾	n. 
bazaar	集市	n. 
be	是，存在	v. 
beach	海滩，湖滨	n. 
bead	有孔小珠	n. 
beak	鸟嘴	n. 
beam	梁，射线	n. 
bean	豆子	n. 
bear	负担，忍受，生育	v. 
bearing	举止，意义，轴承	n. 
bearish	熊市的	adj. 
beast	野兽，牲畜	n. 
beat	打，击败	v. 
beautiful	美丽的，绝妙的	adj. 
beauty	美，美女	n. 
because	因为，由于	conj. 
become	变成	v. 
bed	床，河床，苗圃	n. 
bedroom	卧室	n. 
bee	蜜蜂	n. 
beef	牛肉	n. 
beer	啤酒	n. 
beetle	甲虫	n. 
before	在...前面	prep. 
beforehand	事先，预先	adv. 
beg	乞讨，恳求	v. 
beggar	乞丐	n. 
begin	开始，着手进行	v. 
beginner	初学者	n. 
beginning	开端，起点	n. 
behalf	代表	n. 
behave	行为，举动	v. 
behavior	行为，举止	n. 
behind	在...后面	prep. 
behindhand	落后，事后	adj. 
being	生物，存在	n. 
belief	信仰，信心	n. 
believe	相信，认为	v. 
bell	钟，铃	n. 
belly	肚子	n. 
belong	属于	v. 
beloved	敬爱的	adj. 
below	在...下面	adj. prep. 
belt	带，腰带	n. 
bench	长凳，工作台	n. 
bend	弯曲，俯身	v. 
beneath	在...之下	prep. 
beneficial	有益的，有利的	adj. 
beneficiary	受益者	n. 
benefit	益处，利益	n. 
benevolence	慈悲，捐助	n. 
benevolent	乐善好施的	adj. 
bent	弯曲的	adj. 
berry	浆果	n. 
beside	在...之旁	prep. 
besides	而且	adj. 
best	最好的	adj. 
bestow	赠给，授予	v. 
best-seller	畅销书(货)	n. 
best-selling	畅销的	adj. 
bet	打赌	n. v. 
betray	背叛，泄露	v. 
betrayal	背叛，暴露	n. 
better	更好的	adj. 
better-off	经济情况较好的	adj. 
between	在两者之间	prep. 
beverage	饮料	n. 
beware	当心	v. 
bewilder	迷惑，茫然	v. 
beyond	在...那边，超出	prep. 
bias	偏好	n. 
bible	圣经	n. 
bicycle	自行车	n. 
bid	报价，投标	n. v. 
bidding	投标	n. 
big	大的，重大的	adj. 
bike	自行车	n. 
bill	帐单，议案，钞票	n. 
billion	十亿	n. 
bind	捆绑，约束	v. 
binding	装订	n. 
biographer	传记记者	n. 
biography	传记	n. 
biologist	生物学家	n. 
biology	生物学	n. 
bird	鸟	n. 
birth	出生，创始	n. 
birthday	生日，诞辰	n. 
birthplace	出生地	n. 
biscuit	饼干	n. 
bishop	主教	n. 
bit	小片，一点	n. 
bite	咬，叮	n. v. 
bitter	苦的，痛苦的	adj. 
bitterly	惨痛地，辛酸地	adv. 
bitterness	苦味，苦难	n. 
black	黑的	adj. 
blackboard	黑板	n. 
blacksmith	铁匠	n. 
blade	刀刃，叶片	n. 
blame	责备	v. 
blank	空白的	adj. 
blanket	毛毯	n. 
blast	阵风	n. 
blaze	火光，光亮	n. 
bleach	漂白，变白	v. 
bleed	出血，流血	v. 
blend	混合，掺混	v. 
bless	保佑，祝福	v. 
blessing	祝福	n. 
blind	瞎的	adj. 
blink	眨眼，闪烁	adj. 
block	大块，街区，障碍物	n. 
blockage	封锁	n. 
blond	金发的	adj. 
blood	血，血统	n. 
bloody	流血的，残忍的	adj. 
bloom	花	n. 
blossom	(果树的)花	n. 
blot	污迹	n. 
blouse	女衫	n. 
blow	吹，吹掉，刮风	v. 
blue	蓝色的，忧郁的	adj. 
blunder	大错	n. 
blunt	钝的，生硬的	adj. 
blush	脸红，害臊	v. 
blushy	害羞的	adj. 
board	木板，伙食，董事会	n. 
boarding	伙食	n. 
boast	夸口，以...而自豪	v. 
boat	小船，艇	n. 
body	身体，尸体，团体	n. 
bodyguard	保镖	n. 
boil	沸腾，煮沸	v. 
boiler	锅炉	n. 
boiling	沸腾的	adj. 
bold	大胆的	adj. 
boldness	胆略	n. 
bolt	螺检，插销	n. 
bomb	炸弹	n. 
bomber	轰炸机	n. 
bonafide	真诚的，无欺的	adj. 
bond	束缚，联结，债券	n. 
bonded	保税的	adj. 
bone	骨，骨骼	n. 
bonus	红利	n. 
bony	骨头的	adj. 
book	书	n. 
bookcase	书橱	n. 
booking	定货	adj. 
booklet	小册子	n. 
bookshelf	书架	n. 
bookstore	书店	n. 
boom	隆隆响，兴旺，繁荣	v. 
booming	兴旺的，繁荣的	adj. 
boost	抬高，促进	v. 
boot	靴子	n. 
booth	货摊，电话亭	n. 
border	国界，边境	n. 
bore	烦扰，使厌烦，钻孔	v. 
boring	讨厌的	adj. 
born	出生的，天生的	adj. 
borrow	借，借用	v. 
borrowings	借款	n. 
bosom	胸，胸怀	n. 
boss	上司，老板	n. 
bossy	好发号施令的	adj. 
both	双方，两	pron. adj. 
bother	打扰，麻烦	v. 
bottle	瓶子	n. 
bottle-neck	影响...的环节	n. 
bottom	底部，末尾	n. 
bottom-line	末行数字，结果	n. 
bough	大树枝	n. 
bounce	跳起	v. 
bound	缚，以...为界	v. 
boundary	界线，边界	n. 
bourgeois	资产阶级分子	n. 
bow	鞠躬，服从	v. 
bowl	碗，钵	n. 
bowling	保龄球	n. 
box	箱，盒	n. 
boxer	拳击运动员	n. 
boxing	拳击	n. 
boxing-day	节礼日	n. 
boy	男孩，小伙子	n. 
boycott	抵制	v. n. 
brace	支撑	n. 
bracket	括号	n. 
brag	吹嘘，夸口	v. 
brain	脑子，头脑，智能	n. 
brake	制动器	n. 
brake	刹车	n. 
branch	树枝，分支，分部	n. 
brand	牌子，商标	n. 
brandy	白兰地	n. 
brass	黄铜	n. 
brave	勇敢的	adj. 
bravely	勇敢地	adv. 
bravery	勇敢	n. 
brazil	巴西	n. 
brazilian	巴西的(人)	adj. n. 
breach	违反(契约)	n. 
bread	面包，生计	n. 
bread-earner	挣钱养家的人	n. 
breadth	宽度，大量	n. 
break	打破，破坏	n. 
breakage	裂口	n. 
breakdown	故障，衰竭	n. 
breakfast	早饭	n. 
breakthrough	突破	n. 
breast	乳房，胸脯	n. 
breath	呼吸，气息	n. 
breathe	呼吸	v. 
breed	繁殖，饲养	v. 
breeze	微风	n. 
bribe	贿赂	v. 
bribery	贿赂	v. 
brick	砖	n. 
bride	新娘	n. 
bridegroom	新郎	n. 
bridge	桥梁，桥牌	n. 
bridle	约束	n. 
brief	简短的	adj. 
briefing	简要情况	n. 
briefly	简单地，简短地	adv. 
bright	明亮的，鲜明的	adj. 
brighten	使发光	v. 
brightness	光辉，明亮	n. 
brilliance	辉煌，光彩	n. 
brilliant	辉煌的，杰出的	v. 
brim	边，边缘	n. 
bring	拿来，带来	v. 
brink	边缘	n. 
brisk	敏捷的，活跃的	adj. 
bristle	鬃毛	n. 
britain	不列颠，英国	n. 
british	英国的，英属的	adj. 
brittle	易碎的，脆的	adj. 
broad	宽的，辽阔的	adj. 
broadcast	广播	v. n. 
broadcasting	广播节目	n. 
broaden	加宽，扩大	v. 
brochure	产品介绍手册	n. 
broken	破碎的，毁坏了的	adj. 
broker	经纪人	n. 
bronze	青铜	n. 
brood	一窝	n. 
brook	小河，溪流	n. 
broom	扫帚	n. 
brother	兄弟，同胞	n. 
brotherhood	兄弟情谊	n. 
brother-in-law	姻兄(弟)	n. 
brow	眉毛，额	n. 
brown	褐色(的)	n. adj. 
bruise	青肿	n. 
brush	刷子，画笔	n. 
brutal	野蛮的	adj. 
brute	禽兽，畜生	n. 
bubble	气泡	n. 
bucket	水桶	n. 
bud	芽，蓓蕾	n. 
buddhism	佛教	n. 
buddhist	佛教徒	n. 
budget	预算	n. 
buffalo	水牛，野牛	n. 
buffet	冷餐	n. 
bug	臭虫，虫子	n. 
bugle	喇叭	n. 
build	建造，建设	v. 
builder	建筑工人，建设者	n. 
building	建筑物，大楼	n. 
bulb	球形物，灯泡	n. 
bulk	体积，大半	n. 
bulky	庞大的，笨重的	adj. 
bull	公牛	n. 
bullet	子弹	n. 
bulletin	公报	n. 
bullion	金块，金条	n. 
bullish	行情看涨的	adj. 
bump	碰，颠簸	v. 
bumpy	颠簸不平的	adj. 
bunch	一束	n. 
bundle	捆，包	n. v. 
burden	担子，负担	n. 
burdensome	沉重的	adj. 
bureau	局，司，办公室	n. 
bureaucracy	官僚主义	n. 
bureaucratic	官僚主义的	adj. 
burglar	夜盗，窃贼	n. 
burglary	盗窃	n. 
burial	埋葬	n. 
burn	烧，燃烧，烧伤	v. 
burner	喷灯	n. 
burnt	烧焦的，烧坏的	adj. 
burst	爆炸，破裂	v. n. 
bury	掩埋，安葬	v. 
bus	公共汽车	n. 
bush	灌木	n. 
bushel	蒲式耳(重量单位)	n. 
business	行业，买卖，商号	n. 
businesslike	事务式的	adj. 
busy	忙碌的，热闹的	adj. 
but	但是，除了	prep. 
butcher	屠夫	n. 
butchery	肉食店	n. 
butt	根端	n. 
butter	黄油	n. 
butterfly	蝴蝶	n. 
button	钮扣，按钮	n. 
buy	买，购买	v. 
buyer	购买者	n. 
buzz	嗡嗡叫	v. 
by	在...旁边，按照	prep. 
bygone	已往的，过时的	n. 
bypass	旁道，分路	n. 
by-product	副产品	n. 
c/o	(缩)请转交...	v. 
cab	出租汽车	n. 
cabbage	卷心菜	n. 
cabin	小屋，船舱	n. 
cabinet	橱柜，内阁	n. 
cable	电缆，海底电报	n. 
cafe	咖啡馆	n. 
cafeteria	自助餐厅	n. 
cage	笼子，鸟笼	n. 
cake	糕，饼	n. 
calculate	计算，估计	v. 
calculation	计算(结果)	n. 
calculus	微积分	n. 
calendar	日历	n. 
calf	小牛，腿肚子	n. 
calibration	刻度，核定	n. 
call	叫，称为，打电话	v. 
calm	宁静的，镇静的	adj. 
calmly	平静地，沉着地	adv. 
calorie	热卡，卡路里	n. 
camel	骆驼	n. 
camera	照相机	n. 
camp	帐篷，野营	n. 
campaign	战役，运动	n. 
camping	野营	n. 
campus	校园	n. 
can	能，会，可以	v. 
canada	加拿大	n. 
canadian	加拿大的(人)	adj. n. 
canal	运河，渠道	n. 
canary	金丝雀	n. 
cancel	删除，取消	v. 
cancellation	删除，取消	n. 
cancer	癌	n. 
candid	坦白的，直率的	adj. 
candidate	候选人	n. 
candle	蜡烛	n. 
candy	糖果	n. 
cane	手杖，(藤、竹的)茎	n. 
canned	罐装的	adj. 
cannon	大炮	n. 
canoe	独木舟，游艇	n. 
canon	规范，准则	n. 
canteen	食堂	n. 
canvas	帆布，画布	n. 
canvass	游说	v. 
cap	帽子，盖子	n. 
capability	才能，能力	n. 
capable	有能力的	adj. 
capacity	容量，容积，资格	n. 
cape	披肩，岬，海角	n. 
capita	人	n. 
capital	首都，资本	n. 
capital-intensive	资本密集型的	adj. 
capitalism	资本主义	n. 
capitalist	资本主义的	adj. 
capitalization	资本化	n. 
capitalize	大写，资本化	v. 
captain	队长，船长，上尉	n. 
caption	标题	n. 
captive	被俘虏的	adj. 
capture	俘获，捉拿	v. n. 
car	小汽车	n. 
caravan	车队，大蓬车	n. 
carbon	碳，复写纸	n. 
card	卡片，纸牌，名片	n. 
cardboard	硬纸板	n. 
cardinal	主要的	adj. 
care	注意，小心	n. 
career	职业，生涯	n. 
careful	小心的，仔细的	adj. 
careless	粗心的，不关心的	adj. 
carelessness	粗心	n. 
cargo	货物	n. 
carol	颂歌	n. 
carpenter	木匠	n. 
carpet	地毯	n. 
carriage	马车，(火车)车厢	n. 
carrier	运载工具，媒介	n. 
carrot	胡萝卜	n. 
carry	搬运，携带	v. 
cart	手推车	n. 
carton	纸箱	n. 
cartoon	漫画，动画片	n. 
cartridge	弹仓	n. 
carve	雕刻，切	v. 
carving	雕塑	n. 
case	事实，案例，箱子	n. 
cash	现金	n. 
cashier	出纳	n. 
cassette	小盒，磁盘盒	n. 
cast	掷，投射，铸造	v. 
castle	城堡	n. 
casual	偶然的，随便的	adj. 
casualty	伤亡	n. 
cat	猫	n. 
catalog	(商品)目录	n. 
catalyst	催化剂	n. 
catastrophe	灾难	n. 
catch	捕获，染病	v. 
category	种类，范畴	n. 
cater	提供	v. 
cathedral	大教堂	n. 
catholic	天主教的	adj. 
cattle	牛(总称)	n. 
cause	原因，理由，事业	n. 
caution	谨慎，告诫	n. 
cautious	谨慎的，当心的	adj. 
cavalry	骑兵，马术	n. 
cave	洞穴，山洞	n. 
cavern	酒馆	n. 
cavity	坑，孔穴	n. 
cease	停止，平息	v. 
ceiling	天花板	n. 
celebrate	庆祝	v. 
celebration	庆祝仪式	n. 
celery	芹菜	n. 
cell	细胞，牢房，电池	n. 
cellar	地窖，地下室	n. 
cement	水泥	n. 
cemetery	墓场	n. 
censor	审查	v. 
censorship	审查	n. 
cent	分币	n. 
center	中心	n. 
centigrade	摄氏的	adj. 
centimeter	厘米	n. 
central	中心的，中央的	adj. 
century	世纪	n. 
cereal	谷物	n. 
ceremonial	仪式的	adj. 
ceremony	仪式，典礼，礼节	n. 
certain	确信的，一定的	adj. 
certainly	一定，当然，行	adv. 
certainty	确实，必然的事	n. 
certificate	证书，执照	n. 
certification	证明	n. 
certify	证明	v. 
chain	链条，一系列，锁链	n. 
chair	椅子	n. 
chairman	主席，董事长	n. 
chairperson	主席(无性别之分)	n. 
chairwoman	女主席，女董事长	n. 
chalk	白垩，粉笔	n. 
challenge	挑战，质问	n. v. 
challenging	具有挑战性的	adj. 
chamber	房间	n. 
champion	优胜者，冠军	n. 
championship	锦标(赛)	n. 
chance	机会，可能性	n. 
change	变化，零钱	n. 
changeable	变化的	adj. 
channel	沟渠，途径，频道	n. 
chaos	混乱	n. 
chap	伙计	n. 
chapter	章，节	n. 
character	性格，角色，特牲	n. 
characteristic	特征，特性	n. 
characteristical	特征的	adj. 
characterize	具有...特征	v. 
charcoal	木炭	n. 
charge	收费，冲向，控告	v. 
charity	施舍，仁慈	n. 
charm	魅力	n. 
charming	迷人的	adj. 
chart	图表	n. 
charter	特许证，宪章	n. 
chase	追逐，驱除	v. 
chat	聊天	v. 
chatter	喋喋不休，啁啾	v. 
cheap	便宜的，可鄙的	adj. 
cheat	欺骗，作弊	v. 
cheating	欺骗行为	n. 
check	检验，核对	v. 
check-out	结帐，离店时限	n. 
check-up	核对，检查	n. 
cheek	颊，脸	n. 
cheeky	胖乎乎的	adj. 
cheer	喝彩	n. 
cheerful	快活的	adj. 
cheese	干酪，奶酪	n. 
chemical	化学的	adj. 
chemist	化学家，药剂师	n. 
chemistry	化学	n. 
cheque	支票	n. 
cherish	珍爱，怀有	v. 
cherry	樱桃	n. 
chess	国际象棋	n. 
chest	胸膛，柜子	n. 
chestnut	栗树，栗子	n. 
chew	咀嚼	v. 
chick	小鸡	n. 
chicken	鸡，鸡肉	n. 
chief	首席的，首要的	adj. 
chiefly	多半，首要地	adv. 
child	孩子，儿童	n. 
childhood	童年	n. 
childish	孩子气的	adj. 
childlike	孩子似的，天真的	adj. 
chill	寒意	n. 
chilly	凉的，冷淡的	adj. 
chimney	烟囱	n. 
chin	下巴，下颊	n. 
china	中国	n. 
china	瓷器，陶瓷	n. 
chinese	中国的	adj. n. 
chip	片，屑，缺口	n. 
chocolate	巧克力	n. 
choice	选择，选中的人或物	n. 
choke	闷死，窒息，阻塞	v. 
choose	选择，愿意	v. 
chop	劈，剁	v. 
chorus	合唱队，齐声	n. 
christ	基督	n. 
christian	基督教的	adj. 
christianity	基督教(精神)	n. 
christmas	圣诞节	n. 
church	教堂	n. 
cif	(缩)到岸价	n. 
cigar	雪茄	n. 
cigarette	卷烟	n. 
cinema	电影院	n. 
circle	圆，果	n. 
circuit	巡回，电路	n. 
circular	圆圈的	adj. 
circulate	循环，流通，流传	v. 
circulation	循环，销路，周转	n. 
circumference	周围，圆周	n. 
circumstance	情况，环境	n. 
circus	马戏团	n. 
cite	引证，举例	v. 
citizen	公民，市民	n. 
citizenship	公民权	n. 
city	城市	n. 
civil	民用的，民事的	adj. 
civilization	文明，民族文化	n. 
civilize	使...文明，开化	v. 
claim	要求，索赔，声称	v. 
clamp	夹子	n. 
clap	排手，鼓掌	v. 
clarification	澄清	n. 
clarify	弄清(问题)	v. 
clash	碰撞，冲突	v. n. 
clasp	扣子	n. 
class	阶级，种类，班级	n. 
classic	经典作品	n. 
classical	经典的，古典的	adj. 
classification	分类	n. 
classify	分类，分等	v. 
classmate	同班同学	n. 
classroom	教室	n. 
clatter	咔嗒响	v. 
clause	条款，从句	n. 
claw	爪	n. 
clay	黏土	n. 
clean	清洁的，干的	adj. 
clear	清楚的，明确的	adj. 
clearance	结关	n. 
clearly	清晰地，无疑地	adv. 
clench	咬紧，握紧，决定	v. 
clerk	办事员，职员，店员	n. 
clever	聪明的，灵巧的	adj. 
cleverness	聪明，机灵	n. 
client	当事人，顾客，用户	n. 
clientele	顾客(总称)	n. 
cliff	悬崖，峭壁	n. 
climate	气候	n. 
climax	顶点，高潮	n. 
climb	爬，攀登，上升	v. 
cling	粘住，依附	v. 
clinic	诊所	n. 
clip	夹子，卡子	n. 
cloak	外套，借口	n. 
clock	时钟	n. 
clockwise	顺时针的	adj. adv. 
close	关闭，结束	v. 
closed	关闭的，停业的	adj. 
closely	紧密地，严密地	adv. 
closet	壁橱	n. 
cloth	织物，布，衣料	n. 
clothe	给...着衣	v. 
clothes	衣服(总称)	n. 
clothing	服装(总称)	n. 
cloud	云	n. 
cloudy	多云的	adj. 
clown	小丑，丑角	n. 
club	俱乐部，会，棍棒	n. 
clue	线索	n. 
clumsy	笨拙的，愚蠢的	adj. 
cluster	群，串	n. 
clutch	抓紧	v. n. 
coach	客车，教练	n. 
coal	煤	n. 
coarse	粗糙的，粗的	adj. 
coast	海岸，海滨	n. 
coastal	沿海的	adj. 
coat	上衣，涂层	n. 
cock	公鸡	n. 
cocktail	鸡尾酒	n. 
code	法规，代码，密码	n. 
codify	编码	v. 
coefficient	系数	n. 
coffee	咖啡	n. 
coffin	棺材	n. 
coherence	凝聚性	n. 
coherent	有条理的，粘着的	adj. 
cohesion	凝聚力，团结	n. 
cohesive	有粘性的	adj. 
coil	卷曲	v. 
coin	硬币，创造新词	n. 
coinage	重合，一致	v. 
coincide	巧合，同时发生	n. 
coincidence	同时发生的	adj. 
coincident	冷，冷冰冰的	adj. 
coldness	寒冷，冷淡	n. 
collaborate	协作，勾结	v. 
collaboration	协作，通敌	n. 
collapse	倒塌	v. 
collar	领子	n. 
colleague	同事，同行	n. 
collect	收集，征收，聚集	v. 
collection	收集，收藏	n. 
collective	集体	n. 
college	学院	n. 
collide	猛烈碰撞，冲突	v. 
collision	猛烈碰拉，冲突	n. 
colonel	上校	n. 
colonial	殖民的，殖民地的	adj. 
colonist	殖民者，移民	n. 
colonist	殖民主义	n. 
colony	殖民地	n. 
color	颜色，色彩，气色	n. 
color-blind	色盲的	adj. 
colorful	色彩丰富的	adj. 
colorless	无色的	adj. 
column	圆柱，栏	n. 
columnist	专栏作家	n. 
comb	梳	v. 
combat	战斗，斗争	v. n. 
combination	混合，组合	n. 
combine	组合，化合，结合	v. 
come	来到，出现，发生	v. 
comedian	喜剧演员	n. 
comedy	喜剧	n. 
comfort	舒适，慰藉	n. 
comfortable	舒适的，自在的	adj. 
comic	喜剧的，滑稽的	adj. 
command	命令，控制	v. n. 
commander	司令，指挥官	n. 
commandment	称赞	n. 
commemorate	纪念	n. 
commemoration	纪念	v. 
commence	开始	v. 
commend	称赞，推荐	v. 
comment	评论	n. v. 
commerce	商业	n. 
commercial	商业的，商务的	adj. 
commission	委托，委任	n. v. 
commit	委托，犯(错误)	v. 
commitment	责任	n. 
committee	委员会	n. 
commodity	商品	n. 
common	共同的，普通的	adj. 
commonly	通常，平常	adv. 
commonplace	平凡的，平淡的	adj. 
commonsense	常识	n. 
commonwealth	共同体，联邦	n. 
commune	公社	n. 
communicate	传播，通讯	v. 
communication	通信，通讯系统	n. 
communicative	通讯的	adj. 
communism	共产主义	n. 
communist	共产主义者	n. 
community	团体，共同体，群体	n. 
compact	严密的，紧凑的	adj. 
companion	同伴，伴侣	n. 
company	公司，同伴	n. 
comparable	可比较的	adj. 
comparative	比较的，相当的	adj. 
comparatively	比较地	adv. 
compare	比较，比作	v. 
comparison	比较	n. 
compass	指南针，圆规	n. 
compatible	可兼容的，一致的	adj. 
compel	强迫，逼迫	v. 
compels	强迫	v. 
compensate	赔偿，补偿，酬报	v. 
compensation	赔偿，补偿	n. 
compete	竞争，比赛	v. 
competent	称职的，有能力的	adj. 
competition	竞争，比赛	n. 
competitive	竞争的	adj. 
competitiveness	竞争能力	n. 
competitor	竞争者，对手	n. 
compile	编(书)，编辑	v. 
complain	抱怨，控诉	v. 
complaint	怨言，控告	n. 
complement	补充，余数	n. 
complete	完成，结束	v. 
completely	完全地，十分	adv. 
completion	完成，完满	n. 
complex	综合的，复杂的	adj. 
complexity	复杂性	n. 
compliance	顺从，应允	n. 
complicate	使复杂	v. 
complicated	错综复杂的	adj. 
compliment	称赞，问候	n. v. 
complimentary	称赞的	adj. 
comply	履行，遵守	v. 
component	成分，组分	n. 
componential	成分的	adj. 
compose	由...组成，作曲	v. 
composed	镇静的	adj. 
composer	作曲家	n. 
composite	合成的，组合的	adj. 
composition	作文，组成	n. 
compound	化合物	n. 
comprehend	理解，了解	v. 
comprehension	理解	n. 
comprehensive	综合的，广泛的	adj. 
compress	压缩	v. 
compression	压缩，凝缩	n. 
comprise	包括，由...组成	v. 
compromise	妥协，和解	n. v. 
compulsory	强制的，必修的	adj. 
computation	计算	n. 
compute	计算	v. 
computer	计算机	n. 
computerization	计算机化	n. 
computerize	使...计算机化	v. 
comrade	同志	n. 
conceal	隐瞒，隐藏	v. 
concede	让步，输	v. 
conceit	自负，自大	n. 
conceited	自负的	adj. 
conceive	想象，怀孕	v. 
concentrate	集中，浓缩	v. 
concentrated	全神贯注的	adj. 
concentration	专心，浓度	n. 
concept	概念	n. 
conception	想法，概念	n. 
conceptive	概念的	adj. 
concern	涉及，关心	v. 
concerned	有关的	adj. 
concerning	关于	prep. 
concert	音乐会	n. 
concerted	齐心协力的	adj. 
concess	让步	v. 
concession	让步，减免，租界	n. 
concise	简明的，简要的	adj. 
conclude	结束，缔结，断定	v. 
conclusion	结束，结论	n. 
conclusive	结束的，结论性的	adj. 
concrete	混凝土	n. 
concur	同地发生	v. 
concurrence	合作，并发	n. 
concurrent	同时发生的	adj. 
condemn	谴责，判刑	v. 
condemnation	谴责，判决	n. 
condensation	凝聚	n. 
condense	凝结，冷凝，精简	v. 
condenser	冷凝器，聚光器	n. 
condition	状态，情形，条件	n. 
conditional	有条件的	adj. 
conduce	导致，有益于	v. 
conducive	有助于...的	adj. 
conduct	行为，管理	n. 
conduction	传导，传热	n. 
conductor	(乐队)指挥，售票员	n. 
cone	锥体，锥形	n. 
confer	授予，颁布，商议	v. 
conference	会议	n. 
confess	坦白，供认	v. 
confession	供认，自由	n. 
confide	委托，吐露秘密	v. 
confidence	信任，信心	n. 
confident	确信的，自信的	adj. 
confidential	机密的	adj. 
confine	限制	v. 
confinement	限制	n. 
confirm	证实，确认，批准	v. 
confirmation	确认	n. 
conflict	冲突，斗争	v. n. 
conform	遵守，使...一致	v. 
conformity	遵照，一致	n. 
confront	面对，与...相对	v. 
confrontation	面对，对峙	n. 
confuse	混淆，弄糊涂，搅乱	v. 
confusion	混乱，糊涂	n. 
congestion	阻塞，消化不良	n. 
congratulate	祝贺	v. 
congratulation	祝贺，贺辞	n. 
congress	(代表)大会，国会	n. 
congressman	国会议员	n. 
conjunction	连词，联结	n. 
connect	连接，联想	v. 
connection	联系，社会关系	n. 
conquer	征服，战胜	v. 
conqueror	征服者，胜利者	n. 
conquest	征服	n. 
conscience	良心，良知	n. 
conscientious	有良心的	adj. 
conscientiously	认真地	adv. 
conscious	意识到的，自觉的	adj. 
consciousness	知觉，意识	n. 
consecutive	连续的，连贯的	adj. 
consent	同意，允许	v. n. 
consequence	后果，重要性	n. 
consequently	因而，所以	adv. 
conservation	保护，保存	n. 
conservative	保守的，稳健的	adj. 
consider	考虑，以为，体谅	v. 
considerable	相当的，可观的	adj. 
considerably	相当	adv. 
considerate	考虑周全的	adj. 
consideration	考虑，照顾	n. 
consign	委托，托运货物	v. 
consignment	委托，货物	n. 
consist	由...组成	v. 
consistency	一致(性)	n. 
consistent	始终如一的，符合	adj. 
console	安慰	v. 
consolidate	团结	v. 
consolidated	加固的，统一的	adj. 
consolidation	团结	n. 
consonant	响亮的	adj. 
conspicuous	显眼的，出众的	adj. 
conspiracy	阴谋	n. 
constable	警官	adv. 
constant	不变的，恒定的	adj. 
constantly	经常地	adv. 
constituent	组成的	adj. 
constitute	组成，构成，设立	v. 
constitution	宪法，章程	n. 
constitutive	宪法的，章程的	adj. 
constraint	强制，拘束	n. 
construct	建设，建立	v. 
construction	建设，建筑	n. 
construe	翻译，解释	v. 
consul	领事	n. 
consulate	领事馆	n. 
consult	咨询，磋商	v. 
consultant	咨询顾问(公司)	n. 
consultation	咨询	n. 
consume	消费，消耗	v. 
consumer	消费者，用户	n. 
consumption	消费，消耗量	n. 
contact	接触，联系	n. v. 
contain	含有，容纳，抑制	v. 
container	容器，集装箱	n. 
contemplate	沉思	v. 
contemplation	苦思冥想	n. 
contemporarian	同时代人	n. 
contemporary	当代的，同时代的	adj. 
contempt	轻视，蔑视	n. 
contemptuous	轻视的	adj. 
content	含量，内容	n. 
contest	争夺，比赛	n. v. 
contestant	参赛人	n. 
context	上下文，语境，环境	n. 
contextual	上下文的，环境的	adj. 
continent	节制的	adj. 
continental	大陆的	adj. 
contingency	事故，意外	n. 
continual	连续的，频繁的	adj. 
continuance	连续	n. 
continue	继续，连续，依旧	v. 
continuous	持续的，不断的	adj. 
continuously	连续不断地	adv. 
contract	契约，合同	n. 
contracted	合同所规定的	adj. 
contractual	合同的，契约的	adj. 
contradict	反驳，与...矛盾	v. 
contradiction	矛盾，反驳	n. 
contrary	相反的	adj. 
contrast	对照，对比	n. v. 
contribute	捐献，贡献，投稿	v. 
contribution	贡献，捐献物	n. 
control	控制，管理	v. n. 
controversial	有争议的	adj. 
controversy	论战，论争	n. 
convenience	方便，便利	n. 
convenient	便利的，方便的	adj. 
convention	大会，协定，惯例	n. 
conventional	传统的，常规的	adj. 
conversant	精通的，有交情的	adj. 
conversation	会话，谈话	n. 
converse	谈话，对话，交往	v. 
conversely	相反地	adv. 
conversion	转变，转化，换算	n. 
convert	转换，改变信仰	v. 
convey	运输，传达	v. 
conveyance	运送，传达	n. 
convict	罪犯	n. 
conviction	定罪，确信	n. 
convince	使...确信，信服	v. 
convinced	信服的	adj. 
cook	烹调，烧	v. 
cooker	厨具，厨灶	n. 
cool	凉的，冷静的	adj. 
coolness	凉爽，冷淡	n. 
cooperate	合作，协作	v. 
cooperation	合作，协作	n. 
cooperative	合作的	adj. 
coordinate	协调，配合	v. 
coordination	协调，配合	n. 
cope	应付，对付	v. 
copper	铜	n. 
copy	抄写，复制	v. 
cord	细绳，电线	n. 
cordial	诚恳的，亲切的	adj. 
cordially	亲切地	adv. 
core	核，核心	n. 
cork	软木塞	n. 
corn	谷物，玉米	n. 
corner	角落，拐角	n. 
corporate	有限公司	n. 
corporation	公司	n. 
correct	正确的，恰当的	adj. 
correction	修改，校正	n. 
correctly	正确地	adv. 
correlate	相关，关联	v. 
correlation	相互关系	n. 
correspond	符合，通信，相当于	v. 
correspondence	相应，通信	n. 
correspondent	对应的	adj. 
corresponding	相应的，通信的	adj. 
corridor	走廓	n. 
corrode	腐蚀	v. 
corrosion	腐蚀	n. 
corrupt	腐败的，腐化的	adj. 
corruption	腐败，腐化	n. 
cosmetics	化妆品	n. 
cosmic	宇宙的	adj. 
cosmopolitan	大都市	n. 
cosmos	宇宙	n. 
cost	成本，费用	n. 
costly	昂贵的	adj. 
cottage	村舍	n. 
cotton	棉花，棉布，棉纱	n. 
couch	躺椅	n. 
cough	咳嗽	v. n. 
council	理事会，委员会	n. 
counsel	劝告，辩护律师	n. 
counsellor	顾问	n. 
count	计算，数，认为	v. 
countable	可计算的	adj. 
countenance	容貌，支持	n. 
counter	柜台	n. 
countermand	撤回，取消	v. 
countermeasure	对策	n. 
counter-offer	还价，还盘	n. 
counterpart	同类的人或物	n. 
countersign	副署，会签	v. 
countersignature	副署，会签	n. 
countless	无数的	adj. 
country	国家，乡间，故乡	n. 
countryside	乡下	n. 
county	县，郡	n. 
couple	一对，几个，夫妇	n. 
courage	勇气，胆量	n. 
courageous	勇敢的	adj. 
course	过程，路线，课程	n. 
court	法庭，宫廷，球场	n. 
courteous	有礼貌的	adj. 
courtesy	礼貌，礼仪，好意	n. 
courtyard	院子	n. 
cousin	堂(或表)兄弟姐妹	n. 
cover	盖，掩盖	v. 
coverage	覆盖率	n. 
covering	包括的	adj. 
cow	母牛，奶牛	n. 
coward	懦夫	n. 
cowardly	胆小地	adv. 
crab	蟹	n. 
crack	使...破裂	v. 
cracker	苏打饼干，克力架	n. 
cradle	摇篮，发源地	n. 
craft	工艺，手艺，飞机	n. 
craftsman	手艺人	n. 
craftsmanship	手艺	n. 
crane	鹤，起重机	n. 
crash	碰撞	v. 
crate	一箱，篓，筐	n. 
crave	渴望，恳求	v. 
crawl	爬行，徐徐行进	v. 
craziness	疯狂	n. 
crazy	疯狂的，迷恋的	adj. 
cream	乳脂，奶油	n. 
creamy	奶油的，奶黄色的	adj. 
create	创造，创作，造成	v. 
creation	创造，创造物	n. 
creative	有创造力(性)的	adj. 
creature	家伙，生物	n. 
credit	信誉，信用	n. 
creditworthiness	商誉	n. 
creditworthy	有信誉的	adj. 
creek	小川，小湾	n. 
creep	爬行，蔓延	v. 
crew	(飞机等的)全体人员	n. 
cricket	板球，蟋蟀	n. 
crime	罪，罪行	n. 
criminal	罪犯	n. 
crimson	深红色(的)	adj. n. 
cripple	跛子	n. 
crisis	危险，危险期	n. 
crisp	松脆的，鲜嫩的	adj. 
critic	评论家，爱挑剔的人	n. 
critical	批评的，危急的	adj. 
criticism	批评	n. 
criticize	批评，评论	v. 
crook	钩子	n. 
crooked	弯曲的，歪的	adj. 
crop	作物，庄稼	n. 
cross	十字，交叉	n. 
crossing	交叉，十字路口	n. 
crossroads	交叉路口，十字路	n. 
crouch	蹲下，缩着	v. 
crow	乌鸦	n. 
crowd	人群	n. 
crown	王冠	n. 
crude	未加工的，粗糙的	adj. 
cruel	残酷的，残忍的	adj. 
cruelty	残忍，残酷行为	n. 
cruise	巡游，巡航	v. 
crumb	面包屑	n. 
crumble	粉碎，崩溃	adj. 
crush	压榨，粉碎	v. 
crust	面包皮，硬的表面	n. 
crutch	拐杖	n. 
cry	叫喊，哭泣	v. n. 
crystal	水晶，晶体	n. 
cube	立方体，三次方	n. 
cubic	立方的	adj. 
cubism	立体主义	n. 
cuckoo	布谷鸟，杜鹃	n. 
cucumber	黄瓜	n. 
cultivate	耕作，栽培，培养	v. 
cultivation	耕作，培养	n. 
cultural	文化的	adj. 
culture	文化，养殖	n. 
cunning	狡猾的，狡诈的	adj. 
cup	杯子，一杯	n. 
cupboard	碗橱	n. 
curb	制止，束缚	v. 
cure	治疗，矫正	v. n. 
curiosity	好奇心，古玩	n. 
curious	好奇的，爱打听的	adj. 
curl	卷曲，缭绕	v. 
curly	卷曲的，波浪式的	adj. 
currency	通货，货币	n. 
current	现令的	adj. 
currently	当前，广泛地	adv. 
curse	诅咒，咒骂	n. v. 
curtail	削减，剥夺	n. 
curtain	窗帘，幕布	n. 
curve	曲线，弯曲	n. 
cushion	垫子，靠垫	n. 
custody	保管，监护	n. 
custom	风俗，习惯	n. 
customary	习惯的，通常的	adj. 
customer	顾客，主顾	n. 
customs	海关	n. 
cut	割，切，削减，切断	v. 
cutlery	刀具，餐刀	n. 
cutter	刀具，裁剪者	n. 
cutting	切片，剪辑	n. 
cycle	周期，循环，自行车	n. 
cyclist	自行车运动员	n. 
cylinder	圆筒，柱，汽缸	n. 
d/a	(缩)承兑交单	n. 
dacron	涤纶	n. 
dad	爸爸	n. 
dagger	匕首	n. 
daily	每日的	adj. 
dainty	优雅，考究	adj. 
dairy	奶牛场，乳品商店	n. 
dam	坝	n. 
damage	损害，破坏	v. n. 
damn	诅咒	v. n. 
damp	潮湿的	adj. 
dance	跳舞	v. 
dancer	舞蹈者，舞蹈演员	n. 
danger	危险，威胁	n. 
dangerous	有危险的	adj. 
danish	丹麦人(的)	adj. n. 
dare	敢，挑战，竟敢	v. 
daring	大胆的，勇敢的	adj. 
dark	黑暗的	adj. 
darken	变黑，转暗	v. 
darkness	黑暗	n. 
darling	爱人	n. 
dart	飞标游戏	n. 
dash	猛冲,泼溅	v. 
data	(复数)资料，数据	n. 
date	日期	n. 
dating	约会	n. 
daughter	女儿	n. 
daughter-in-law	儿媳	n. 
dawn	黎明，开端	n. 
day	一天，白天	n. 
daybreak	破晓	n. 
daylight	日光，白昼	n. 
daytime	日间	n. 
daze	耀眼，使迷乱	v. 
dazzle	使...眼花缭乱	v. 
dazzling	令人目眩的	adj. 
dead	死的	adj. 
deadline	期限	n. 
deadly	致命的，死一般的	adj. 
deaf	聋的	adj. 
deafen	使...聋，震聋	v. 
deal	处理，交易	v. 
dealer	商人，贩子	n. 
dealing	交往，生意	n. 
dean	系主任	n. 
dear	亲爱的，敬爱的	adj. 
death	死，死亡	n. 
deathly	致死的	adj. 
debate	辩论，讨论	v. n. 
debit	借方	n. 
debt	债，债务	n. 
decade	十年	n. 
decay	腐烂，衰败	v. n. 
deceased	已死的	adj. 
deceit	欺骗，欺诈行为	n. 
deceitful	欺骗性的	adj. 
deceive	欺骗	v. 
december	十二月	n. 
decency	体面	n. 
decent	体面的，象样的	adj. 
deception	欺诈	n. 
decide	决定，判决	v. 
decided	明确的，果断的	adj. 
decidedly	明确地，果断的	adv. 
decimal	十进制的，小数的	adj. 
decision	决定，决议	n. 
decisive	决定性，明确的	adj. 
deck	甲板	n. 
declaration	宣布，宣告	n. 
declare	宣布，声明	v. 
decline	婉谢，推辞	v. 
declining	下降的，衰落的	adj. 
decompose	分解，腐烂	v. 
decorate	装饰	v. 
decoration	装饰物	n. 
decorative	装饰的，装璜的	adj. 
decrease	减少	v. n. 
decree	法令	n. 
dedicate	奉献，致力	v. 
deduce	演绎，推断	v. 
deduct	减	v. 
deduction	推断，减少	n. 
deed	行为，契据	n. 
deem	以为，认为	v. 
deep	深的，深远的	adj. 
deepen	加深，深化	v. 
deeply	深深的，深切地	adv. 
deer	鹿	n. 
default	不履行，不负责	n. v. 
defeat	击败	v. 
defect	缺点，缺陷	n. 
defective	有缺点的	adj. 
defence	保卫，防御	n. 
defend	保卫，为...辩护	v. 
defer	拖延	v. 
defiance	蔑视，挑战	n. 
defiant	无礼的，挑战的	adj. 
deficiency	缺乏	n. 
deficient	缺乏的，不足的	adj. 
deficit	赤字	n. 
define	下定义，界定，规定	v. 
definite	明确的，限定的	adj. 
definitely	明确地，肯定地	adv. 
definition	定义，解释	n. 
definitive	定义的	adv. 
deflate	收缩，紧缩	v. 
deflect	偏斜	v. 
deflection	偏转，偏斜	n. 
deform	使变形，使残废	v. 
deformation	变形	n. 
defray	支付	v. 
defy	反抗，蔑视，使不能	v. 
degradation	降低，恶化	n. 
degrade	败低，下降，堕落	v. 
degree	程度，度，学位	n. 
delay	耽搁，延误	v. n. 
delcredere	保付	n. 
delegate	代表	n. 
delegation	代表团	n. 
delete	删除	v. 
deletion	删除	n. 
deliberate	故意的，审慎的	adj. 
deliberately	故意地，从容地	adv. 
deliberation	慎重，故意	n. 
delicacy	精致	n. 
delicate	优雅的，精致的	adj. 
delicious	美味的	adj. 
delight	快乐，乐事	n. 
delightful	令人高兴的	adj. 
delinquency	轻微犯罪	n. 
delinquent	拖欠的	adj. 
deliver	交付，递送，讲述	v. 
deliverance	救助	n. 
delivery	交付，递送，讲述	n. 
delusion	错觉	n. 
delusive	令人产生错觉的	adj. 
demand	要求，需求	v. n. 
demanding	对人要求严格的	adj. 
democracy	民主，民主政体	n. 
democrat	民主党人	n. 
democratic	民主的	adj. 
demolish	拆除	v. 
demolition	拆除	n. 
demonstrate	论证，演示，表明	v. 
demonstration	示范，表演，示威	n. 
demurrage	滞期费	n. 
den	窝	n. 
denial	拒绝，否定	n. 
denmark	丹麦	n. 
denominate	为...命名	v. 
denomination	命名	n. 
denote	表示	v. 
denounce	谴责，斥责	v. 
dense	稠密的，浓厚的	adj. 
density	密度，稠密	n. 
dent	牙，槽，凹陷	n. 
dentist	牙科医生	n. 
deny	否认，拒绝	v. 
depart	离去，出发，违反	v. 
department	部，部门，系	n. 
departure	离开，违背	n. 
depend	依靠，依赖	v. 
dependability	可依赖性	n. 
dependable	可依赖的	adj. 
dependant	受赡养者	n. 
dependence	依靠，依赖	n. 
dependent	依靠的，随...而定	adj. 
depict	描述，描画	v. 
depiction	描述	n. 
deplete	减少，耗尽	v. 
deposit	存放，储蓄	v. 
deposition	免职，罢官	n. 
depreciate	降价，贬值，折旧	v. 
depreciation	折旧，贬值	n. 
depress	抑制，使人抑郁	v. 
depressed	情绪低落的	adj. 
depression	沮丧，萧条	n. 
deprive	剥夺，丧失	v. 
depth	深度	n. 
deputy	代表	n. 
derivation	起源，衍生物	n. 
derive	从...而来，得来	v. 
derrick	钻塔，井架	n. 
descend	降临，下来，遗传	v. 
descendant	子孙，后裔	n. 
descent	下降，血统	n. 
describe	描写，作图	v. 
description	描述，形容	n. 
desert	遗弃，擅离	v. 
deserve	应受，值得	v. 
design	设计，旨在	v. 
designate	指明，指定	v. 
designation	指定，委派	n. 
designer	设计者	n. 
desirable	合乎要求的	adj. 
desire	欲望，要求	n. 
desk	课桌，写字台	n. 
desolate	荒芜的，凄凉的	adj. 
desolation	荒凉，凄凉	n. 
despair	绝望	n. v. 
desperate	不顾一切的	adj. 
desperation	绝望	n. 
despise	鄙视，看不起	v. 
despite	不管，任凭	prep. 
dessert	(最后一道)甜食	n. 
destination	终点，目的地	n. 
destine	注定，预定	v. 
destiny	命运，定数	n. 
destroy	破坏，摧毁，消灭	v. 
destruction	破坏，毁灭	n. 
destructive	破坏性的	adj. 
detach	分离，拆开	v. 
detail	细节	n. 
detailed	详细的，详尽的	adj. 
detain	留住，阻止	v. 
detect	发现，侦察	v. 
detection	发现，侦查	n. 
detective	侦探	n. 
deteriorate	恶化，败坏	v. 
deterioration	退化	n. 
determination	决心，决定	n. 
determine	决心，决定，测定	v. 
detour	绕道，绕开	v. 
detract	降低	v. 
detriment	损害	n. 
detrimental	有害的	adj. 
devaluation	贬值	n. 
devalue	贬值	v. 
develop	发展，开发，成长	v. 
developing	发展中的	adj. 
development	进展，发展	n. 
deviate	背离	v. 
deviation	背离，偏向	n. 
device	装置，方法	n. 
devil	魔鬼，恶人	n. 
devise	设计，计划	v. 
devote	奉献，贡献	v. 
devoted	献身于...的	adj. 
devotion	献身，专心	n. 
devour	吞吃，吞没	v. 
dew	露水	n. 
diagnose	诊断	v. 
diagnosis	诊断	n. 
diagram	图表，图解	n. 
dial	钟盘	n. 
dialect	方言	n. 
dialog	对话，对白	n. 
diameter	直径	n. 
diamond	钻石，金刚石	n. 
diary	日记	n. 
dictate	口授，命令	v. 
dictation	口授，听写	n. 
dictator	独裁者	n. 
dictatorship	独裁，专政	n. 
diction	措辞	n. 
dictionary	词典，字典	n. 
die	死，消亡	v. 
diesel	内燃机，柴油机	n. 
diet	饮食，节食	n. 
differ	不同，相异	v. 
difference	差异，差别	n. 
different	不同的，各种	adj. 
differential	有差别的	adj. 
differently	不同地	adv. 
difficult	困难的	adj. 
difficulty	困难，难题	n. 
dig	挖，采掘	v. 
digest	消化	v. 
digestion	消化	n. 
digit	数字	n. 
digital	数字的	adj. 
dignity	尊贵，尊严	n. 
dike	堤	n. 
diligent	勤奋的，用功的	adj. 
dilute	稀释	v. 
dim	暗淡的，模糊的	adj. 
dime	(美元)一角	n. 
dimension	维，方面，尺寸	n. 
dimensional	尺寸的	adj. 
diminish	减少，缩小	v. 
dine	用餐	v. 
dingy	肮脏的	adj. 
dining-room	餐厅	n. 
dinner	正餐，晚餐，宴会	n. 
dip	蘸，浸	v. n. 
diploma	毕业文凭，学位证书	n. 
diplomacy	外交	n. 
diplomat	外交人员	n. 
diplomatic	外交的	n. 
direct	支配，指挥，对准	v. 
direction	方向，指示，说明	n. 
directive	命令，指令	n. 
directly	直接地，立即	adv. 
director	指导者，导演，领导	n. 
directory	目录，地址录	n. 
dirt	尘埃，灰尘，泥土	n. 
dirty	肮脏的	adj. 
disable	使残废	v. 
disabled	残废的	adj. 
disadvantage	不利之处	n. 
disadvantageous	不利的	adj. 
disagree	意见不合，不符	v. 
disagreement	不和，不一致	n. 
disallow	不允许	v. 
disappear	失踪，消失	v. 
disappearance	消失	n. 
disappoint	使...失望	v. 
disappointed	失望的，扫兴的	adj. 
disappointment	失望	n. 
disapproval	不批准	n. 
disaster	自然灾害，祸患	n. 
disastrous	灾难性的	adj. 
disburse	支付	v. 
disbursement	支付	n. 
disc	圆盘，唱片	n. 
discard	丢弃，扔掉	v. n. 
discern	操作别，辨明	v. 
discharge	解除，放出，卸货	v. 
disciplinary	纪律的，学科的	adj. 
discipline	训练，纪律	n. 
disclaim	放弃，不承认	v. 
disclose	揭开，透露	v. 
discomfort	不安，不舒服	n. 
discomfortable	不舒服的	adj. 
discontinue	中断	v. 
discount	折扣	n. v. 
discourage	使...泄气，阻止	v. 
discourse	演说，谈话，话语	n. 
discover	发现	v. 
discovery	发现，发现物	n. 
discreet	周到的，慎重的	adj. 
discreetly	慎重地	adv. 
discrepancy	单货不符	n. 
discretion	慎重	n. 
discriminate	区别，岐视	v. 
discrimination	辨别，岐视	n. 
discuss	讨论	v. 
discussion	讨论，商议	v. 
disdain	轻视	v. 
disease	疾病	n. 
disgrace	耻辱	n. 
disgraceful	耻辱的，受辱的	adj. 
disguise	伪装，掩饰	v. n. 
disgust	厌恶	n. 
disgustful	令人生厌的	adj. 
dish	盘子，碟子	n. 
dishonor	耻辱	n. 
dishonorable	不名誉的	adj. 
disillusion	使觉醒，幻灭	v. 
disinclined	不愿意的	adj. 
disinfectant	消毒剂	n. 
disintegration	分散，解体	n. 
dislike	厌恶	v. n. 
disloyal	不忠的	adj. 
disloyalty	不忠	adj. 
dismal	阴郁的，沉闷的	adj. 
dismay	使沮丧	v. 
dismiss	解散，开除	v. 
dismissal	解散，开除	n. 
disobey	不服从	v. 
disorder	紊乱，骚乱，失调	n. 
disparity	不同，悬殊	n. 
dispatch	迅速派遣	v. 
dispel	驱散	v. 
dispense	分配，施予	v. 
disperse	驱散，散布	v. 
displace	置换，取代	v. 
displacement	置换，替换物	n. 
display	陈列，表现	v. n. 
displease	使生气，惹怒	v. 
displeasure	不快	n. 
disposal	处置，对付	n. 
dispose	处置，对付，解决	v. 
disposed	有...倾向的	adj. 
disposition	布置，处置	n. 
dispute	争论，质疑	v. 
disregard	无视，不顾	v. n. 
dissatisfaction	不满	n. 
dissatisfy	使不满	v. 
dissimilar	不同的	adj. 
dissipate	驱散，消耗，浪费	v. 
dissolve	溶解，使终结	v. 
distance	距离，远处	n. 
distant	远方的，疏远的	adj. 
distillation	蒸馏	n. 
distinct	不同的，明显的	adj. 
distinction	差别，非凡	n. 
distinctly	明晰地，清楚地	adv. 
distinguish	辨别，认出	v. 
distinguished	尊贵的，尊敬的	adj. 
distort	扭曲，歪曲	v. 
distortion	曲解，失真，变形	n. 
distract	分神，迷惑	v. 
distraction	分心	n. 
distress	苦恼，不幸	n. 
distribute	分配，分布，分销	v. 
distribution	分配，分布	n. 
distributor	分销商	n. 
distributorship	分销权	n. 
district	区，区域，地区	v. 
disturb	打扰，打乱，使烦恼	v. 
disturbance	干扰，动乱	n. 
disunite	使分裂	v. 
disuse	废止	v. n. 
ditch	沟，渠，下水道	n. 
ditto	同上	n. 
dive	潜水，跳水，俯冲	v. 
diver	潜水员，跳水运动员	n. 
diverge	分歧，离题	v. 
divergence	分歧	n. 
diverse	不同的，分歧的	adj. 
diversion	转移，消遣	n. 
diversity	多样化	n. 
divert	使转向，消遣	v. 
divide	分开，分享，分裂	v. 
divine	神的，神圣的	adj. 
division	划分，部分	n. 
divorce	离婚，使脱离	v. 
dizzy	晕眩的	adj. 
do	做，干，足够，制作	v. 
dock	码头	n. 
doctor	医生，博士	n. 
doctrine	教义，学说	n. 
document	文件，公文	n. 
documentary	文化的	adj. 
documentation	提供文件	n. 
dodge	躲避	v. 
dog	狗	n. 
doggedly	顽固地	adv. 
doll	玩偶，娃娃	n. 
dollar	元，美元	n. 
domain	领土，领域	n. 
dome	圆顶，穹窿	n. 
domestic	家里的，国内的	adj. 
dominant	统治的	adj. 
dominate	统治，支配，占优势	v. 
donate	捐献	v. 
donation	捐献	n. 
donkey	驴，笨蛋	n. 
doom	命运，判决	n. 
door	门，(一户)人家	n. 
doorway	门口，门道	n. 
dormitory	集体宿舍	n. 
dose	剂量，一服药	n. 
dot	点，圆点	n. 
double	两倍的，双重的	adj. 
doubt	怀疑，疑惑	v. n. 
doubtful	怀疑的，可疑的	adj. 
doubtless	无疑地，大约	adv. 
dough	面团	n. 
dove	鸽子	n. 
down	向下，下降	adv. 
downstairs	在楼下	adv. 
downtown	闹市	n. 
downward	向下的，下坡的	adj. 
downwards	向下，以下	adv. 
doze	打瞌睡	v. 
dozen	一打	n. 
draft	草案，草稿，穿堂风	n. 
drag	拖，拽	v. 
dragon	龙	n. 
drain	排水，耗竭，泄	v. 
drainage	排水系统，污水	v. 
drama	戏剧，剧本	n. 
dramatic	戏剧性的，显著的	adj. 
dramatist	戏剧家	n. 
dramatize	使戏剧化	v. 
drastic	激烈的，严厉的	adj. 
draw	画，拉，吸引	v. 
drawback	不利，欠缺	n. 
drawer	抽屉	n. 
drawing	素描，绘画，图样	n. 
dread	恐惧，担心	v. n. 
dreadful	可怕的，糟糕的	adj. 
dream	梦，梦想	n. 
dreary	疲劳的	adj. 
drench	浸泡，充满	v. 
dress	服装	n. 
dressing	打扮，调味品	n. 
drift	漂流，游荡	v. 
drill	钻头，操练	n. 
drink	喝，饮	v. 
drip	滴下，流下	v. 
drive	驾驶，乘车	v. 
driver	司机	n. 
droop	下垂	v. 
drop	落下	v. 
dropout	中途退出者	n. 
drought	旱灾	n. 
drown	淹死	v. 
drug	药物，麻醉剂	n. 
drugstore	零食店	n. 
drum	鼓	n. 
drunk	喝醉的	adj. 
drunkard	醉鬼	n. 
dry	干的，枯燥的	adj. 
dubious	怀疑的	adj. 
duck	鸭子	n. 
due	到期的，预定的	adj. 
duke	公爵	n. 
dull	沉闷的，钝的	adj. 
duly	按期地	adv. 
dumb	哑的	adj. 
dummy	傀儡	n. 
dump	倾倒	v. 
dumping	倾销	n. 
dung	粪	n. 
dungeon	地牢	n. 
duplicate	二重的，复制的	adj. 
durable	持久的，耐用的	adj. 
duration	期间，待续时间	n. 
during	在...期间	prep. 
dusk	黄昏	n. 
dust	尘土，粉末	n. 
dustbin	簸箕	n. 
dusty	沾满灰尘的	adj. 
duty	责任，义务，关税	n. 
duty-free	免税的	adj. 
dwarf	矮子，侏儒	n. 
dwell	居住	v. 
dweller	居住者，住客	n. 
dwelling	住宅	n. 
dye	染料	n. 
dynamic	动力的，动态的	adj. 
dynasty	朝代，王朝	n. 
each	名，每个	adj. adv. 
eager	热切的，渴望的	adj. 
eagle	鹰	n. 
ear	耳朵，穗	n. 
earl	伯爵	n. 
early	早的，初期的	adj. 
earmark	标记，特征	n. 
earn	挣钱，赢得	v. 
earnest	认真的，诚恳的	adj. 
earnings	收入，赚得的钱	n. 
earphone	耳机	n. 
earth	地球，地上，泥土	n. 
earthly	世俗的	adj. 
earthquake	地震	n. 
ease	安逸，轻易	n. 
easily	容易地，安逸地	adv. 
east	东方的	adj. 
easter	复活节	n. 
eastern	东的，朝东的	adj. 
eastward	向东	adv. 
easy	容易的，轻松的	adj. 
easy-going	逍遥自在的	adj. 
eat	吃	v. 
eccentric	性格怪僻的	adj. 
eccentricity	怪僻	n. 
echo	回声，反响，共呜	n. 
eclipse	(日、月)食，蚀	n. 
ecology	生态学	n. 
economic	经济的，经济学的	adj. 
economical	节省的，经济的	adj. 
economically	经济上	adv. 
economics	经济学	n. 
economize	节省	v. 
economy	经济，节约	n. 
ecstasy	狂喜	n. 
edge	边，边缘，刀刃	n. 
edit	校订，编辑	v. 
edition	片(本)	n. 
editor	编辑，编者	n. 
editorial	社论	n. 
educate	教育	v. 
education	教育，训练	n. 
educational	教育的	adj. 
eel	鳝鱼	n. 
effect	后果，效力	n. 
effective	有效的	adj. 
effectively	有效地	adv. 
effectiveness	有效	n. 
efficiency	效率，功效	n. 
efficient	效率高的	adj. 
effort	努力，尽力，成果	n. 
egg	卵，蛋，鸡蛋	n. 
eggplant	茄子	n. 
egypt	埃及	n. 
egyptian	埃及人(的)	adj. n. 
eight	八	num. 
eighteen	十八	num. 
eighth	第八，八分之一	num. 
eighty	八十	num. 
either	二者之一	adj. 
eject	喷射	v. 
ejection	喷射	n. 
elaborate	详尽阐述	v. adj. 
elaboration	详尽阐述	n. 
elapse	(时间)消逝	v. 
elastic	弹性的，灵活的	adj. 
elasticity	弹性	n. 
elbow	肘，弯管	n. 
elder	年长的，资格老的	adj. 
elect	选举	v. 
election	选举	n. 
electric	电的，电力的	adj. 
electrical	电的	adj. 
electrician	电工	n. 
electricity	电	n. 
electrify	充电，电气化	v. 
electron	电子	n. 
electronic	电子的	adj. 
electronics	电子学	n. 
elegance	优雅	n. 
elegant	优雅的，典雅的	adj. 
element	成分，元素	n. 
elemental	自然力的，基本的	adj. 
elementary	基础的，初步的	adj. 
elephant	象	n. 
elevate	提升，抬高	v. 
elevation	海拔，提高，崇高	n. 
elevator	电梯	n. 
eleven	十一	num. 
eleventh	第十一	num. 
eliminate	消灭，删除	v. 
elimination	消灭，删除	n. 
ellipsis	省略	n. 
elliptical	椭圆的，省略的	adj. 
eloquence	雄辩，口才	n. 
eloquent	雄辩的，有口才的	adj. 
else	别的	adj. 
elsewhere	在别处	adv. 
elusive	躲闪的	adj. 
email	電子郵件	n. 
emancipate	解放	v. 
emancipation	解放	n. 
embargo	禁运	n. 
embark	登陆	v. 
embarrass	使窘，使为难	v. 
embarrassing	令人尴尬的	adj. 
embarrassment	窘迫，尴尬	n. 
embassy	使馆	n. 
embody	体现，包含	v. 
embrace	拥抱，接受，包括	v. 
embroider	绣	v. 
embroidery	刺绣(品)	v. 
emerge	出现，暴露	v. 
emergency	紧急情况，急诊	n. 
emigrant	移居国外的人	n. 
emigrate	移居国外，移民	v. 
emigration	向国外移民	n. 
eminent	杰出的，突出的	adj. 
emission	发射，散发	n. 
emit	发射，散发	v. 
emotion	感情，情绪	n. 
emotional	感情的，激动的	adj. 
emperor	皇帝	n. 
emphasis	强调，重点，重读	n. 
emphasize	强调，着重	v. 
emphatic	强调的，着重的	adj. 
empire	帝国，财团	n. 
empirical	经验的	adj. 
employ	雇用，使用，从事	v. 
employee	雇员	n. 
employer	雇主	n. 
employment	职业，就业	n. 
emptiness	空虚，空白	n. 
empty	空的，空虚的	adj. 
enable	使能够，使可能	v. 
enchant	迷住，陶醉	v. 
encircle	环绕，包围	v. 
enclose	围住，圈起，封入	v. 
enclosure	围绕，附件	n. 
encounter	面临，遭遇	v. 
encourage	鼓舞，鼓励，助长	v. 
encouragement	鼓舞，鼓励	n. 
encyclopaedia	百科全书	n. 
end	结尾	n. 
endanger	危及，危害	v. 
endeavor	努力，尽力	v. n. 
ending	结局	n. 
endless	无穷无尽的	adj. 
endorse	背签	v. 
endorsement	背书	n. 
endow	资助，赋予，授予	v. 
endurance	忍耐力，耐用	n. 
endure	忍受，容忍，持久	v. 
endures	最终用户	n. 
enemy	敌人，对手	n. 
energetic	精力旺盛的	adj. 
energy	精力，活力，能量	n. 
enforce	实施，强制	v. 
engage	从事，雇用，吸引	v. 
engaged	占用的，从事…的	adj. 
engagement	约束，约会，婚约	n. 
engine	发动机，火车头	n. 
engineer	工程师	n. 
engineering	工程	n. 
england	英格兰，英国	n. 
english	英国的，英语	n. adj. 
englishman	英国人	n. 
engrave	刻上，牢记	v. 
engraving	雕刻	adj. 
engulf	吞没	v. 
enhance	提高，增加	v. 
enhancement	提高	n. 
enjoy	欣赏，享有，享受	v. 
enjoyable	愉快的	adj. 
enjoyment	享受，乐趣	n. 
enlarge	扩大，扩展，放大	v. 
enlargement	扩大	n. 
enlighten	启发，教导	v. 
enlightening	给人启发的	adj. 
enormous	巨大的，庞大的	adj. 
enough	足够(的)	adj. adv. 
enquire	询问	v. 
enquiry	询问	v. 
enrich	使富裕	v. 
enroll	登记，招收	v. 
enrolment	招收	n. 
enroute	在途中	adv. 
ensure	保证，担保，保护	v. 
entail	遗留给，引起	v. 
enter	进入，加入	v. 
enterprise	事业，企业	n. 
entertain	招待，使欢乐	v. 
entertainment	招待，娱乐	n. 
enthusiasm	热情，热心	v. 
enthusiastic	热情的，热心的	adj. 
entire	完全的，全部的	adj. 
entirely	完全地，彻底地	adv. 
entirety	全部	n. 
entitle	给...权利，资格	v. 
entrance	进入，入口	n. 
entreat	恳求，请求	v. 
entrust	委托	v. 
entry	进入，入口，词条	n. 
enumerate	列举	v. 
envelop	包，围绕	v. 
envelope	信封	n. 
envious	嫉妒的	adj. 
environment	环境	n. 
environmental	环境的	adj. 
envy	嫉妒，羡慕	v. n. 
epidemic	传染的	adj. 
episode	事件，情节，插曲	n. 
epoch	时代，纪元	n. 
epoch-making	划时代的	adj. 
equal	相等的，胜任的	adj. 
equality	平等，相等	n. 
equally	相等地，相同地	adv. 
equation	等式，方程式	n. 
equator	赤道	n. 
equilibrium	平衡，均衡	n. 
equip	装备，配备	v. 
equipment	设备，器材，装置	n. 
equivalence	相等，等值	n. 
equivalent	相等的，等值的	adj. 
era	时代，年代	n. 
eradicate	根除	v. 
eradication	根除	n. 
erase	擦掉，抹去	v. 
erasure	抹去	n. 
erect	树立，建立，竖立	v. 
erection	竖立，建立	n. 
erosion	腐蚀，侵蚀	n. 
err	犯错误	v. 
errand	差事，差使	n. 
error	错误，过失	n. 
erupt	喷发，爆发	v. 
eruption	喷发，爆发	n. 
escalator	电动扶梯	n. 
escape	逃跑，避免，被遗忘	v. 
escort	护送	v. 
especial	特别的，专门的	adj. 
especially	特别地，专门地	adv. 
essay	散文，论文，小品文	n. 
essayist	散文作家	n. 
essence	本质，情髓，香精	n. 
essential	必需的，本质的	adj. 
essentially	本质上，实质上	adj. 
establish	建立，设立，确立	v. 
established	已建立的	adj. 
establishment	建立，组织	n. 
estate	房地产，财产	n. 
esteem	尊重	v. n. 
estimate	估算，预算	v. n. 
estimation	估算，估计	n. 
eternal	永恒的，无休止的	adj. 
europe	欧洲	n. 
european	欧洲人(的)	n. adj. 
evaluate	估价，评价	v. 
evaluation	估价，评价	n. 
evaporate	蒸发，脱水，消失	v. 
evaporation	蒸发，升华	n. 
eve	前夕，前夜	n. 
even	平坦的，均匀的	adj. 
evening	傍晚，晚上	n. 
evenly	平坦地，均匀地	adv. 
event	事件，场合，比赛	n. 
eventful	多事的	adj. 
eventually	最终，终于	adv. 
ever	曾经，总是，究竟	adv. 
everlasting	永久的，持久的	adj. 
every	每个，所有的	adj. 
everybody	人人，每人	pron. 
everyday	每日的，日常的	adj. 
everyone	人人，每人	pron. 
everything	事事，一切	pron. 
everywhere	处处，到处	adv. 
evidence	证据，迹象	n. 
evident	明显的，明白的	adj. 
evidently	明显地，显然	adv. 
evil	坏的，邪恶的	adj. 
evolution	发展，渐进，进化	v. 
evolve	发展，进化	v. 
ex	在...交货	prep. 
exact	精确的，精密的	adj. 
exactly	确切地，正是	adv. 
exaggerate	夸张，夸大	v. 
exaggerated	言过其辞的	adj. 
exaggeration	夸张	n. 
exalt	抬高，发扬	v. 
exalted	高贵的，得意的	adj. 
exam	考试	n. 
examination	检查，考试	n. 
examine	检查，细看，考试	v. 
example	例子，榜样	n. 
exasperate	激怒，恶化	v. 
exasperation	愤慨，加剧	n. 
exceed	超过，过度	v. 
exceedingly	非常，极端地	adv. 
excel	胜过，优于	v. 
excellence	优秀，卓越	n. 
excellent	优秀的，卓越的	adj. 
except	除...外	prep. 
exception	除外，例外	n. 
exceptional	异常的，例外的	adj. 
excess	过量，过剩	n. 
excessive	过分的，极度的	adj. 
exchange	交换，兑换	v. 
excite	刺激，使兴奋	v. 
excited	兴奋的	adj. 
excitement	兴奋，激动	n. 
exciting	令人激动的	adj. 
exclaim	呼喊，感叹	v. 
exclamation	呼喊，感叹	n. 
exclude	排除，拒绝考虑	v. 
exclusion	排除	n. 
exclusive	独有的	adj. 
exclusively	独占地	adv. 
exclusivity	独家经营权	n. 
excursion	短途游览	n. 
excuse	原谅	v. 
execute	执行，实施，处决	v. 
execution	执行，处决	n. 
executive	执行的	adj. 
exemplify	举例说明	v. 
exempt	免除	v. 
exercise	锻炼，练习，运用	n. 
exercise-book	练习簿	n. 
exert	尽(力)，发挥	v. 
exertion	尽力，竭力	n. 
exhaust	竭尽，用完	v. 
exhausted	精疲力竭的	adj. 
exhaustion	用尽，详述	n. 
exhaustive	详尽的	adj. 
exhibit	展出,显示	v. 
exhibition	展览会，表现	n. 
exile	放逐	v. 
exist	存在，生存	v. 
existence	存在，生存	n. 
existing	现存的，已有的	adj. 
exit	出口，安全门，离开	n. 
exonerate	昭雪，解除	v. 
exoneration	免罪，免除	n. 
expand	扩张，膨胀，扩充	v. 
expansion	扩张，扩大	n. 
expect	盼望，期待，预料	v. 
expectation	期待，前程	v. 
expedience	便利，权宜之计	n. 
expedient	方便的，临时的	adj. 
expedite	加快，急送	v. 
expedition	探险，考察队	n. 
expel	驱逐，开除	v. 
expend	花费，消耗	v. 
expenditure	支出，费用	n. 
expense	支出，开支	n. 
expensive	昂贵的，高价的	adj. 
experience	经历，经验	n. v. 
experienced	有经验的	adj. 
experiment	实验，试验	n. v. 
experimental	实验的	adj. 
experimentation	实验	n. 
expert	专家，能手	n. 
expertise	专家队伍(总称)	n. 
expiration	期满	n. 
expire	到期，断气	v. 
expiry	逾期	n. 
explain	解释，说明	v. 
explanation	说明，解释	n. 
explanatory	说明的	adj. 
explicit	清楚的，明晰的	adj. 
explicitly	清晰地	adv. 
explode	爆炸，激增	v. 
exploit	开发，利用，剥削	v. 
exploitation	开发，利用	n. 
exploration	勘探，考察	n. 
explore	勘探，考察	v. 
explorer	勘探者，探险家	n. 
explosion	爆炸，爆发，激增	n. 
explosive	爆炸性的	adj. 
export	输出，出口	v. n. 
exportation	出口	n. 
exporter	出口商	n. 
expose	暴露，揭露，陈列	v. 
exposition	展览会，说明	n. 
exposure	揭露，曝光	n. 
express	表达，快递	v. 
expression	表达，措辞，表情	n. 
expressive	有表现力的	adj. 
expressly	明确表示的	adj. 
expressway	高速公路	n. 
exquisite	精致的	adj. 
extend	延伸，扩大，给予	v. 
extension	延伸，电话分机	n. 
extensive	广泛的，密集的	adj. 
extensively	广泛地	adv. 
extent	范围，限度，一大片	n. 
exterior	外部(的)	adj. n. 
external	外部的，对外的	adj. 
extinct	绝灭的，熄灭的	adj. 
extinction	绝灭，熄灭	n. 
extinguish	扑灭，熄灯	v. 
extra	额外的，外加的	adj. 
extract	取出，榨出，摘录	v. 
extraction	出身，摘要	n. 
extraordinary	特别的，格外的	n. 
extravagance	奢侈，浪费	n. 
extravagant	奢侈的，浪费的	adj. 
extreme	极度的，极端的	adj. 
extremely	极其，非常	adv. 
eye	眼睛，孔眼，视力	n. 
eyeball	眼球	n. 
eyebrow	眉毛	n. 
eyeglass	眼镜	n. 
eyelid	眼睑	n. 
eyesight	视力	n. 
fable	寓言	n. 
fabric	织物，结构，组织	n. 
fabricate	制作，捏造	v. 
fabrication	制作，虚构	n. 
face	脸，正面	n. 
facilitate	使便利，使容易	v. 
facility	方便，设施，便利	n. 
fact	事实，真相	n. 
faction	宗派，派别	n. 
factor	因素，因数，要素	n. 
factory	工厂，制造厂	n. 
faculty	本领，学系	n. 
fade	褪色，枯萎	v. 
fahrenheit	华氏(的)	n. adj. 
fail	失败，不及格，不能	v. 
failing	缺点	adj. 
failure	失败，疏忽，破产	n. 
faint	软弱的，模糊的	adj. 
fair	公平的	adj. 
fairly	公平地，相当	adj. 
fairy	妖精，仙女	n. 
faith	信任，信念	n. 
faithful	忠诚的，可靠的	adj. 
faithfully	忠诚地	adv. 
fake	冒片的	adj. 
fall	落下，跌倒	v. 
fame	名声，声誉	n. 
familiar	熟悉的，亲近的	adj. 
familiarity	熟悉，相似	n. 
family	家庭，家属	n. 
famine	饥荒，饥饿	n. 
famous	著名的	adj. 
fan	扇子，...迷	n. 
fanatic	狂热的，入迷的	adj. 
fancy	幻想，爱好	n. 
fantastic	奇异的，荒谬的	adj. 
far	遥远的	adj. 
fare	车费	n. 
farewell	再见	int. 
farm	农场，农庄	n. 
farmer	农夫，农场主	n. 
farmhand	农工，农场工人	n. 
farmhouse	农舍	n. 
farming	农业，种植业	n. 
farther	较远，更进一步	adv. 
fascinate	吸引，入迷，蛊惑	v. 
fascination	入迷	n. 
fascism	法西斯	n. 
fascist	法西斯分子	n. 
fashion	方式，时髦，时装	n. 
fashionable	流行的，时髦的	adj. 
fast	快的	adj. 
fasten	捆紧，钉牢	v. 
fat	脂肪	n. 
fatal	致命的	adj. 
fate	命运，厄运，宿命	n. 
father	父亲，神父，始祖	n. 
father-in-law	岳父，公公	n. 
fathom	领会，推测	v. 
fatigue	(使)疲劳	n. v. 
fault	缺点，过失，断层	n. 
faultless	完美的	adj. 
faulty	有缺点的	adj. 
favor	帮助，偏爱	n. 
favorable	赞成的，有利的	adj. 
favorably	有利地，顺利地	adv. 
favorite	最喜爱的人或物	n. 
fear	害怕，担忧	n. v. 
fearful	可怕的，吓人的	adj. 
fearless	毫不畏惧的	adj. 
feasibility	可行性	n. 
feasible	可行的，做得到的	adj. 
feast	宴会，宴请	n. v. 
feat	功绩	n. 
feather	羽毛	n. 
feature	相貌，特征，特写	n. 
february	二月	n. 
federal	联邦的	adj. 
federation	联邦	n. 
fee	费用，酬金	n. 
feeble	虚弱的，无力的	adj. 
feed	喂养，吃东西	v. 
feedback	反馈	n. 
feel	感到，摸，意识到	v. 
feeling	知觉，感觉，感情	n. 
fell	砍到	v. 
fellow	家伙，同事	n. 
fellowship	交情，会员资格	n. 
female	女性的，雌的	adj. 
feminine	女性的，妇女的	adj. 
fence	围栏，篱笆	n. 
ferocious	凶猛的，野蛮的	adj. 
ferrous	铁的，含铁的	adj. 
ferry	渡船	n. 
ferryboat	渡船	n. 
fertile	肥沃，多产的	adj. 
fertilizer	肥料，化肥	n. 
fervent	强烈的，热烈的	adj. 
festival	节日	n. 
fetch	去取来，去请来	v. 
feud	纠纷，封地	n. 
feudal	封建的	adj. 
feudalism	封建主义	n. 
fever	发烧，狂热	n. 
few	少的	adj. 
fiber	纤维，质地	n. 
fiction	小说，虚构	n. 
fictional	虚构的	adj. 
fiddle	提琴	n. 
field	田野，战场，场	n. 
fierce	凶猛的，猛烈的	adj. 
fiery	火的	adj. 
fifteen	十五	num. 
fifth	第五，五分之一	num. 
fifty	五十	num. 
fig	无花果	n. 
fight	打仗，战斗，作斗争	v. 
fighter	战士	n. 
figurative	比喻的，修饰的	adj. 
figure	数字，图形，人物	n. 
file	档案，纵列，锉刀	n. 
filing	档案管理	n. 
fill	装满，充满，补缺	v. 
filling	充填物，馅	n. 
film	胶片，电影，薄膜	n. 
filter	滤器	n. 
filth	污秽，污物	n. 
filthy	污秽的	adj. 
final	最终的	adj. 
finalize	落实，定下来	v. 
finally	最终，终于	adv. 
finance	金融	n. 
financial	金融的，财政的	adj. 
financier	金融家	n. 
financing	金融业，财政学	n. 
find	寻找，找到，发现	v. 
finding	发现，发现物	n. 
fine	好的，精细的	adj. 
finger	手指	n. 
finish	结束，抛光	v. n. 
finished	制成的	adj. 
finite	有限的，限定的	adj. 
fir	裘皮	n. 
fire	火，火灾	n. 
fire-engine	消防车	n. 
fireman	消防队员	n. 
fireplace	壁炉	n. 
firework	焰火	n. 
firm	坚固的	adj. 
firmly	坚定地，坚固地	adv. 
firmness	坚定，坚固	n. 
first	第一的	adj. 
first-rate	第一流的	adj. 
fish	鱼	n. 
fisherman	渔夫	n. 
fishery	渔业	n. 
fission	裂变，分裂	n. 
fist	拳头	n. 
fit	适合的，健康的	adj. 
fitness	适合，健康	n. 
fitting	适当的	adj. 
five	五	num. 
fix	固定，确定，修理	v. 
fixed	固定的，已确定的	adj. 
fixture	固定物，固定装置	n. 
flag	旗	n. 
flake	片，片状物	n. 
flame	火焰，热情	n. 
flank	侧面，胁腹	n. 
flannel	法兰绒	n. 
flap	拍打	v. 
flare	闪烁	v. n. 
flash	闪光，闪现	n. v. 
flask	瓶，烧瓶	n. 
flat	平的，平淡的	adj. 
flatten	弄平，变平	v. 
flatter	奉承，谄媚	v. 
flavor	滋味，风趣	n. 
flaw	裂缝，瑕疵，缺点	n. 
flee	逃走，消散	v. 
fleece	羊毛	n. 
fleet	船队	n. 
flesh	肌肉，骨肉，果肉	n. 
fleshy	肉的	adj. 
flexibility	柔韧，灵活性	n. 
flexible	柔韧的，灵活的	adj. 
flicker	闪烁	v. 
flight	飞，航班，逃走	n. 
fling	抛，掷	v. 
float	浮，漂	v. 
flock	群	n. 
flood	洪水，大量	n. 
floor	地板，(楼)层	n. 
flour	面粉	n. 
flourish	茂盛，兴旺	v. 
flow	流动	v. 
flower	花，盛期	n. 
flu	流感	n. 
fluctuate	波动，起伏	v. 
fluctuation	波动	n. 
fluency	流利，流畅	n. 
fluent	流利的	adj. 
fluid	液体	n. 
flush	(脸)发红	v. 
flute	长笛，笛子	n. 
flutter	飘动，振翼	v. 
flux	流动，变迁	n. 
fly	飞，驾机	v. 
foam	泡沫	n. 
focus	焦点，中心	n. 
fodder	饲料	n. 
foe	敌人，宿敌	n. 
fog	雾，翳	n. 
foggy	有雾的，雾蒙蒙的	adj. 
fold	折叠	v. 
foliage	叶子(总称)	n. 
folk	人们，乡亲，亲属	n. 
follow	跟随，听懂，遵循	v. 
follower	追随者，信徒	n. 
following	下列的，其次的	adj. 
follow-up	后续(的)	n. adj. 
fond	喜爱...的，慈爱的	adj. 
food	食物，食粮	n. 
foodstuff	食品	n. 
fool	蠢人，傻瓜	n. 
foolish	愚蠢的，笨的	n. 
foot	脚，英尺，最下部	n. 
football	足球	n. 
footing	立足点，立场	n. 
footstep	足迹，脚步声	n. 
for	给，作...用的	prep. 
forbid	禁止，不许	v. 
forbidden	禁止的	adj. 
force	力，力量	n. 
fore	在前面	adj. 
forecast	预测，预报	n. v. 
forefather	祖先，先辈	n. 
forefinger	食指	n. 
foregoing	先行的，上述的	adj. 
forehead	前额	n. 
foreign	外国的，对外的	adj. 
foreigner	外国人，异乡人	n. 
foreman	领班	n. 
foremost	最初的，第一流的	adj. 
foresee	预见，预知	v. 
forest	森林	n. 
forestry	林业	n. 
foretell	预告，预言	v. 
forever	永远，总是	adv. 
forge	打铁，锻造，伪造	v. 
forgery	锻炉，锻造厂	n. 
forget	忘记，疏忽，没想到	v. 
forgive	饶恕，原谅，豁免	v. 
fork	餐叉，岔口	n. 
form	形状，类型，表格	n. 
formal	形式上的，正式的	adj. 
formality	礼节，正式	n. 
format	格式，样式	n. 
formation	形成，构成	n. 
former	以前的，前者	adj. 
formerly	从前，以前	adv. 
formidable	可怕的，难对付的	adj. 
formula	公式	n. 
formulate	系统阐述	v. 
formulation	确切表述	n. 
forsake	遗弃，抛弃	v. 
fort	堡垒，要塞	n. 
forth	向前，向外	adv. 
forthcoming	即将到来的	adj. 
fortitude	坚毅	n. 
fortnight	两星期	n. 
fortress	堡垒，城堡	n. 
fortuity	偶然事件	n. 
fortunate	幸运的，侥幸的	adj. 
fortunately	幸运地，幸而	adv. 
fortune	运气，财富	n. 
forty	四十	num. 
forum	讨论会，座谈会	n. 
forward	向前的	adj. 
fossil	化石，守旧者	n. 
foster	养育，抚养	v. 
foul	肮脏的，邪恶的	adj. 
found	创办，使有根据	v. 
foundation	建立，基金，基础	n. 
founder	创办人，奠基人	n. 
fountain	泉，源泉，喷泉	n. 
four	四	num. 
fourteen	十四	num. 
fourth	第四，四分之一	num. 
fowl	家禽，鸡，禽肉	n. 
fox	狐狸，狡猾的人	n. 
fraction	片断，分数	n. 
fractional	零碎的，不足的	adj. 
fracture	断裂	n. 
fragile	易碎的，脆的	adj. 
fragment	碎片，片断	n. 
fragrance	芬芳，香气	n. 
fragrant	香的，芬芳的	adj. 
frail	脆弱的，虚弱的	adj. 
frame	框架，骨骼	n. 
framework	构架，机构	n. 
france	法国	n. 
franchise	特许权	n. 
frank	坦率的，真诚的	adj. 
frankly	坦率地	adv. 
free	自由的，空闲的	adj. 
freedom	自由，免除	n. 
freely	自由地，随意地	adv. 
freeze	结冰，楞住，冻结	v. 
freezer	冷冻箱	n. 
freight	货运，货物，运费	n. 
french	法国的	adj. 
frenchman	法国人	n. 
frequency	频繁，频率	n. 
frequent	频繁的，经常的	adj. 
frequently	时常，往往	adv. 
fresh	新鲜的，崭新的	adj. 
freshen	使新鲜，使振作	v. 
freshman	新人，新生	n. 
fret	使烦恼	v. 
friction	摩擦，摩擦力	n. 
friday	星期五	n. 
friend	朋友	n. 
friendly	友好的，和气的	adj. 
friendship	友谊，友好	n. 
fright	恐怖，惊吓	n. 
frighten	惊吓，吓唬	v. 
frightening	令人害怕的	adj. 
frightful	可怕的	adj. 
fringe	边缘，花边，穗子	n. 
frock	女上衣，童上装	n. 
frog	蛙	n. 
from	自，从...来	prep. 
front	正面，前线	n. 
frontier	边界，国境，新领域	n. 
frost	霜，霜冻	n. 
frosty	霜的	adj. 
frown	皱眉头，厌恶	v. 
frugal	节俭的	adj. 
fruit	果子，水果，成果	n. 
fruitful	果实累累的	adj. 
frustrate	阻挠，使灰心	v. 
frustration	挫折，灰心	n. 
fry	油煎，炸	v. 
frying-pan	煎锅	n. 
fuel	燃料	n. 
fulfil	完成，满足要求	v. 
fulfillment	完成，成就	n. 
full	满的，完全的	adj. 
fully	完全，彻底	adv. 
fumble	摸索	v. 
fun	娱乐，玩笑，乐趣	n. 
function	作用，集会，函数	n. 
functional	功能的	adj. 
fund	基金，资金，蕴藏	n. 
fundamental	基本的，根本的	adj. 
funeral	葬礼	n. 
funny	有趣的，好笑的	adj. 
fur	毛皮，裘衣	n. 
furious	狂怒的，狂暴的	adj. 
furnace	熔炉	n. 
furnish	供应，装备，摆家具	v. 
furniture	家具(总称)	n. 
furrow	犁沟	n. 
further	更远，进一步	adv. 
furthermore	而且	adv. 
fury	狂暴，狂怒	n. 
fuse	保险丝，导火线	n. 
fuss	忙乱，大惊小怪的	n. 
fussy	爱大惊小怪的	adj. 
future	将来，前途	n. 
futures	期货	n. 
gain	获得，赢得	v. 
gale	大风，定期交付	n. 
gallery	美术馆	n. 
gallon	加仑	n. 
gallop	奔驰，飞跑	v. 
gamble	赌博，投机	v. n. 
gambler	赌徒	n. 
game	游戏，比赛，猎物	n. 
gang	一群，一帮	n. 
gangster	匪徒，歹徒	n. 
gaol	监狱	n. 
gap	空隙，隔阂，山口	n. 
garage	车库，汽车修理站	n. 
garbage	垃圾	n. 
garden	花园，菜园	n. 
gardener	园丁	n. 
gardening	园艺	n. 
garlic	大蒜	n. 
garment	衣服，服装	n. 
garrison	要塞，警备队	n. 
gas	气体，煤气，汽油	n. 
gasoline	汽油	n. 
gasp	喘息，喘气	v. n. 
gate	大门，门票收入	n. 
gather	聚集，收集，采集	v. 
gathering	集会，聚集	n. 
gauge	规格，计量表	n. 
gay	快活的，快乐的	adj. 
gaze	凝视，注视	v. n. 
gear	齿轮，用品	n. 
gem	宝石	n. 
general	一般的，总的	adj. 
generalization	概括	n. 
generalize	总结，归纳	v. 
generally	通常，大概	adv. 
generate	产生，发生，生殖	v. 
generation	世代，一代人	n. 
generator	发电机	n. 
generosity	慷慨，大方	n. 
generous	慷慨的，丰盛的	adj. 
genius	天份，才华，天才	n. 
gentle	温柔的，温和的	adj. 
gentleman	绅士，先生，君子	n. 
gently	轻轻地，温柔地	adv. 
genuine	真正的，道地的	adj. 
geography	地理学，地形	n. 
geology	地质学	n. 
geometry	几何学	n. 
germ	萌芽，起源，细菌	n. 
german	德国的	adj. 
germany	德国	n. 
gesture	姿势，手势，姿态	n. 
get	获得，记住，到达	v. 
get-together	集会，聚会	n. 
ghost	鬼魂，幽灵	n. 
giant	巨人	n. 
gift	礼品，天赋	n. 
gigantic	巨大的	adj. 
giggle	咯咯地笑	v. 
ginger	姜	n. 
girl	少女，姑娘	n. 
giver	给予，付出	v. 
glad	快乐的，高兴的	adj. 
glance	看一眼	v. 
glare	闪耀，瞪眼	n. v. 
glass	玻璃，镜子	n. 
glassware	玻璃制品	n. 
gleam	微光，闪光	n. 
glide	滑行，溜	v. n. 
glimpse	瞥见	v. n. 
glisten	闪光	v. 
glitter	闪闪发光	v. 
global	全世界的，总的	adj. 
globalization	全球化	n. 
globalize	使...全球化	v. 
globe	地球，球体，地球仪	n. 
gloom	黑暗，忧郁	n. 
gloomy	阴沉的，忧郁的	adj. 
glorify	颂扬，赞美	v. 
glorious	光荣的，辉煌的	adj. 
glory	光荣，壮丽，荣誉	n. 
glossary	词汇表	n. 
glove	手套	n. 
glow	发光，发红	v. 
glue	胶水	n. 
glut	供过于求	n. 
gnaw	啃，咬	v. 
gnp	(缩)国民总收入	n. 
go	去，进行，打算	v. 
goal	目标，目的，球门	n. 
goat	山羊	n. 
god	神，上帝	n. 
goddess	女神	n. 
gold	黄金，金币，金色	n. 
golden	黄色的，金黄色的	adj. 
golf	高尔夫球	n. 
good	好的，善良的	adj. 
good-bye	再见	int. 
good-looking	好看的	adj. 
goodness	优良，天哪	n. 
goods	货物，商品	n. 
goodself	你方	n. 
goodwill	商誉	n. 
goose	鹅	n. 
gorge	咽喉，峡谷，山口	n. 
gorgeous	绚丽的，了不起的	adj. 
gorilla	大猩猩	n. 
gossip	闲谈，聊天	n. 
govern	统制，支配，决定	v. 
governess	女家庭教师	n. 
government	编制，政体，政府	n. 
governor	州长，总督	n. 
gown	长袍，法衣	n. 
grab	抓住，攫取	v. 
grace	优美，文雅，恩惠	n. 
graceful	优美的，文雅的	adj. 
gracious	亲切的，客气的	adj. 
grade	等级，年级	n. 
gradual	逐渐的，逐步的	adj. 
gradually	逐渐地，逐步地	adv. 
graduate	毕业生	v. 
graduation	毕业	n. 
grain	谷物，颗粒，一点点	n. 
gram	克	n. 
grammar	语法	n. 
grammatical	语法的	adj. 
gramophone	留声机	n. 
grand	雄伟的，重大的	adj. 
grandchild	(外)孙儿、女	n. 
granddaughter	孙女，外孙女	n. 
grandfather	祖父，外祖父	n. 
grandmother	祖母，外祖母	n. 
grandparent	(外)祖父(母)	n. 
grandson	孙子，外孙	n. 
granite	花岗石	n. 
grant	答应，授予，承认	v. 
grape	葡萄	n. 
graph	图象，图解	n. 
grasp	抓住，领悟	v. n. 
grass	草，禾本植物	n. 
grasshopper	蚱蜢	n. 
grateful	感激的，致谢的	adj. 
gratify	使满足，使高兴	v. 
gratifying	可喜的	adj. 
gratis	免费的	adj. 
gratitude	感激，感谢	n. 
grave	严肃的，庄重的	adj. 
gravel	砂砾，石子	n. 
gravity	引力，严肃	n. 
graze	吃草，擦碰	v. 
grease	润滑油脂	v. 
great	大的，伟大的	adj. 
greatly	大大地，非常地	adj. 
greatness	伟大，大	n. 
greece	希腊	n. 
greed	贪婪，贪心	n. 
greedy	贪婪的	adj. 
greek	希腊人(的)	n. adj. 
green	绿的，没有经验的	adj. 
greengrocer	蔬菜商	n. 
greenhouse	温室	n. 
greet	打招呼	v. 
greeting	问候，致意	n. 
grey	灰色的，阴郁的	adj. 
grief	悲哀，悲伤	n. 
grieve	使悲伤，伤心	v. 
grim	冷酷的，不祥的	adj. 
grin	露齿而笑	v. 
grind	碾碎，磨快，折磨	v. 
grip	紧握，吸引	v. n. 
groan	呻吟	n. 
grocer	杂货铺	n. 
grocery	杂货店	n. 
groove	槽，沟，常规	n. 
grope	摸索，探索	v. 
gross	总的，粗糙的	adj. 
ground	地面，场，根据	n. 
groundless	无根据的	adj. 
group	群，组，团体	n. 
grove	林子，树丛	n. 
grow	增长，成长，种植	v. 
growl	咆哮，嗥叫	v. n. 
grown	已长成的	adj. 
grown-up	成人	n. 
growth	增长，发展，生长	n. 
grudge	嫉妒，吝啬	v. 
grumble	抱怨，咕哝，发牢骚	v. 
grunt	(作)呼噜声	n. v. 
guarantee	保证，担保	n. v. 
guard	警卫，提防	v. 
guardian	保护人	n. 
guess	猜想，推测	v. n. 
guest	客人，宾客，旅客	n. 
guesthouse	宾馆	n. 
guidance	向导，指导	n. 
guide	向导，指引	v. 
guilt	犯罪，过失	n. 
guilty	有罪的，内疚的	adj. 
guitar	吉它，六弦琴	n. 
gulf	海湾，鸿沟	n. 
gulp	吞下	v. 
gum	树胶，口香糖，牙龈	n. 
gun	枪，炮	n. 
gunpowder	火药	n. 
gust	一阵(大风)	n. 
gutter	街沟	n. 
guy	家伙	n. 
gymnasium	体育馆，健身房	n. 
gymnast	体操运动员	n. 
gymnastics	体操	n. 
habit	习惯	n. 
habitual	习惯的，惯常的	adj. 
haggard	消瘦的，憔悴的	adj. 
haggle	争论，讨价还价	n. 
hail	欢呼	v. 
hair	头发，毛发	n. 
haircut	理发	n. 
hairdress	美发	n. 
hairpin	发卡	n. 
hairy	毛发的，多毛的	adj. 
half	一半	n. 
halfway	半途	adv. 
hall	大厅，会堂	n. 
hallmark	标志	n. 
halt	停住	v. n. 
halve	对分，减半	v. 
ham	火腿	n. 
hamburger	汉堡包	n. 
hammer	锤子	n. 
hamper	妨碍	v. 
hand	手，人手，指针	n. 
handbag	手袋，手提包	n. 
handbook	手册	n. 
handful	一把，少量	adj. 
handicap	障碍	n. 
handicapped	有残疾的	adj. 
handkerchief	手帕，手绢	n. 
handle	处理，对待	v. 
handling	处理，管理	n. 
handout	分发物(印刷品等)	n. 
handsome	漂亮的，得体	adj. 
handwriting	手写，书法，笔迹	n. 
handy	方便的，近便的	adj. 
hang	挂，垂，绞死	v. 
hanger	衣架	n. 
haphazard	偶然的	adj. 
happen	发生，碰巧，出事	v. 
happening	事件	n. 
happily	幸运地	adv. 
happiness	幸福	n. 
happy	高兴的，幸运的	adj. 
harbor	港口，停泊处	n. 
hard	硬的	adj. 
harden	硬化，变硬	v. 
hardly	刚刚，几乎不	adv. 
hardness	坚硬，硬度	n. 
hardship	困苦，艰难	n. 
hardware	硬件	n. 
hard-working	勤劳的	adj. 
hardy	耐劳的，耐寒的	adj. 
hare	野兔	n. 
harm	损害，伤害	n. v. 
harmful	有害的	adj. 
harmless	无害的，无恶意的	adj. 
harmonious	和睦的，和谐的	adj. 
harmony	融洽，和谐	n. 
harness	支配，治理	v. 
harsh	刺耳的，严厉的	adj. 
harvest	收获	v. n. 
haste	急忙，急速	n. 
hasten	赶紧，加快	v. 
hasty	急促的，草率的	adj. 
hat	帽子	n. 
hatch	孵化，策划	v. 
hate	恨，憎恶，不愿意	v. 
hateful	可恨的，可憎的	adj. 
hatred	憎恶，敌意	n. 
haughty	傲慢的	adj. 
haul	拉，拖	v. 
haunt	萦绕，作崇	v. 
have	有，不得不，拿	v. 
hawk	鹰隼	n. 
hay	干草	n. 
hazard	危险	n. 
he	他	pron. 
head	头，领导	n. 
headache	头疼，头疼的事	n. 
heading	标题	n. 
headline	通栏标题	n. 
headlong	头向前地，卤莽地	adv. 
headmaster	(中、小学)校长	n. 
headquarters	司令部，总部	n. 
heal	治愈，医治	v. 
health	健康(状况)	n. 
healthy	健康的	adj. 
heap	一堆，许多	n. 
hear	听见，听取，听说	v. 
hearing	听力，审讯	n. 
heart	心，心肠，中心	n. 
heartfelt	衷心的	adj. 
hearth	壁炉，炉边	n. 
heartily	精神饱满的	adv. 
hearty	衷心的，热诚的	adj. 
heat	热，热烈	n. 
heated	激烈的，热烈的	n. 
heating	取暖，供热	n. 
heave	起伏，举起，叹气	v. 
heaven	天空，天堂	n. 
heavily	重，沉重的	adv. 
heavy	星的，繁重的	adj. 
hedge	树篱，套期保值	n. 
hedgehog	刺猬	n. 
heed	注意，留心	v. n. 
heel	后跟	n. 
height	高度，顶点	n. 
heighten	加高，增加	v. 
heir	继承人	n. 
heiress	女继承人	n. 
helicopter	直升飞机	n. 
hell	地狱，苦境	n. 
hello	喂，你好	int. 
helmet	头盔	n. 
help	帮助，有助于	v. n. 
helpful	有用的	adj. 
helpless	无用的，无效的	adj. 
hemisphere	半球，领域	n. 
hen	母鸡	n. 
hence	因此，由此	adv. 
henceforth	今后	adv. 
her	她的，她(宾格)	pron. 
herald	先兆，先驱	n. 
herb	药草	n. 
herbal	草药的	adj. 
herd	放牧	v. 
here	这里，在这里	adv. 
hereafter	此后	adv. 
hereby	以此	adv. 
herein	在此	adv. 
hereinafter	以下	adv. 
hereof	在本文件中	adv. 
hereto	对此	adv. 
herewith	与此一道	adv. 
hero	英雄，男主角	n. 
heroic	英雄的，英勇的	adj. 
heroine	女英雄，女主角	n. 
herself	她自己	pron. 
hesitant	犹豫的	adj. 
hesitate	犹豫，不想	v. 
hesitation	犹豫，踌躇	n. 
hey	嗨	int. 
hi	嗨，你好	int. 
hide	躲藏，隐瞒，掩盖	v. 
hideous	骇人听闻的	adj. 
high	高的，高度的	adj. 
highland	高地	n. 
highly	十分，赞许地	adv. 
highway	公路	n. 
hijack	拦路抢劫	v. 
hijacker	栏路抢劫者	n. 
hike	徒步郊游	n. v. 
hill	小山，丘陵	n. 
hillside	山坡，山腰	n. 
him	他(宾格)	pron. 
himself	他自己	pron. 
hind	后面的，后部的	adj. 
hinder	妨碍，阻止	v. 
hindrance	障碍(物)	n. 
hinge	合页，绞链	n. 
hint	暗示，迹象	n. 
hinterland	内地	n. 
hip	臀部	n. 
hire	租，雇佣	v. 
his	他的	pron. 
hiss	(发)嘶嘶声	v. n. 
historian	历史学家	n. 
historic	历史性的	adj. 
historical	历史的	adj. 
history	历史	n. 
hit	打，碰，打击	v. 
hitchhike	搭车旅行	v. 
hitherto	迄今，到那时	adv. 
hoarse	嘶哑的，沙哑的	adj. 
hobby	嗜好，业余爱好	n. 
hoe	锄头	n. 
hoist	升起，扯起	v. 
hold	握住，容纳	v. 
holder	持有人，支架	n. 
holding	支持，控股	n. 
hold-up	停顿，耽误	n. 
hole	洞，孔穴	n. 
holiday	节日，假日	n. 
hollow	空心的，凹陷的	adj. 
holy	神圣的，圣洁的	adj. 
home	家，故乡	n. 
homeless	无家可归的	adj. 
homely	家常的，简便的	adj. 
homesick	思乡的	n. 
homework	家庭作业	n. 
homogenous	同质的，同类的	adj. 
honest	诚实的，正直的	adj. 
honesty	诚实，正直	n. 
honey	蜂蜜	n. 
honeymoon	蜜月	n. 
honor	荣誉，名誉	n. 
honorable	可尊敬的，体面的	adj. 
hook	钩	n. 
hop	跳跃	v. 
hope	希望，愿望	v. n. 
hopeful	有希望的	adj. 
hopefully	可以指望	adv. 
hopeless	无望的，绝望的	adj. 
horizon	地平线，视野	n. 
horizontal	水平的，横的	adj. 
horn	角，触须，号角	n. 
horrible	可怕的，糟透的	adj. 
horrify	使恐惧	v. 
horror	恐惧，恐怖	n. 
horse	马	n. 
horsepower	马力	n. 
hose	软水管，长统袜	n. 
hospitable	好客的	adj. 
hospital	医院	n. 
hospitality	好客，款待	n. 
host	一大群，男主人	n. 
hostage	人质	n. 
hostel	廉价旅馆	n. 
hostess	女主人，女主持人	n. 
hostile	怀敌意的	adj. 
hot	热的，辣的	adj. 
hotdog	热狗(面包)	n. 
hotel	旅馆	n. 
hotelling	旅馆业	n. 
hound	猎狗	n. 
hour	小时，点钟	n. 
house	房子，剧场，家	n. 
household	户	n. 
housekeeper	看门人，保姆	n. 
housewife	家庭主妇	n. 
housework	家务	n. 
hover	翱翔，盘旋，徘徊	v. 
how	如何，多么，怎样	adv. 
however	可是，然而	adv. 
howl	嚎叫，嚎哭	v. n. 
hug	紧抱	v. n. 
huge	庞大的，巨大的	adj. 
hull	豆荚，外壳，船壳	n. 
hum	哼，嗡嗡叫	v. 
human	人的，人类的	adj. 
humane	人慈的	adj. 
humanism	人道主义	n. 
humanitarian	慈善家	n. 
humanity	人类，人性	n. 
humble	谦卑的，卑贱的	adj. 
humid	湿的，潮湿的	adj. 
humidity	湿度，湿气	n. 
humiliate	使受辱	v. 
humiliation	羞辱，耻辱	n. 
humor	幽默(感)，心情	n. 
humorous	幽默的，诙谐的	adj. 
hundred	一百	num. 
hundredth	第一面，百分之一	num. 
hunger	饥饿，渴望	n. 
hungry	饥饿的，渴望的	adj. 
hunt	打猎，搜索，寻找	v. 
hunter	猎人，搜索者	n. 
hurl	猛掷，猛投	v. 
hurrah	好哇	int. 
hurry	赶紧，急忙，急运	v. 
hurt	使受伤，使痛，伤害	v. 
husband	丈夫	n. 
hush	嘘	int. 
hustle	奔忙	v. 
hut	小屋	n. 
hydraulic	水力的，液压的	adj. 
hydroelectric	水电的	adj. 
hydrogen	氢，氢气	n. 
hygiene	卫生	n. 
hymn	赞美诗，赞歌	n. 
hypocrisy	伪善	n. 
hypothesis	假设，前提	n. 
hypothetical	假设的	adj. 
hysteria	歇斯底里，癔病	n. 
hysteric	亢奋的	adj. 
ice	冰，冰块	n. 
ice-bound	冰封的	adj. 
ice-cream	冰淇淋	n. 
iceland	冰岛	n. 
icy	冰冷的，结了冰的	adj. 
idea	思想，主意，打算	n. 
ideal	理想的	adj. 
idealism	理想主义	n. 
idealize	使理想化	v. 
identical	同一的，相同的	adj. 
identification	识别，身分	n. 
identify	认出，认为...一致	v. 
identity	认同，同一性	n. 
idiom	习语，成语	n. 
idiomatic	习语的，惯用的	adj. 
idiot	傻子，白痴	n. 
idle	空闲的，懒的	adj. 
idleness	闲散，无所事事	n. 
idol	偶像，被崇拜的人	n. 
if	如果，虽然,是否	conj. 
ignite	点燃	v. 
ignorance	无知，不知道	n. 
ignorant	不知道的，无知的	adj. 
ignore	忽视，不理睬	v. 
iIrish	爱尔兰人(的)	n. adj. 
ill	患病的，坏的	adj. 
illegal	不合法的，非法的	adj. 
illegible	字迹不清的	adj. 
illiteracy	文盲	n. 
illiterate	文盲的	adj. 
illness	疾病，生病	n. 
illuminate	照亮，启发	v. 
illusion	幻想，幻觉	n. 
illusive	幻觉的	adj. 
illustrate	图解，用图说明	v. 
illustration	阐明，实例	n. 
image	图像，影像，形象	n. 
imaginary	想象的，虚构的	adj. 
imagination	想象力，想象	n. 
imagine	想象，猜想	v. 
imitate	模仿，仿造，模拟	v. 
imitation	模仿，仿制品	n. 
immaterial	无形的，不重要的	adj. 
immature	不成熟的	adj. 
immediate	立即的，最近的	adj. 
immediately	立即，马上	adv. 
immense	巨大的，极大的	adj. 
immerse	浸泡，埋头于	v. 
immigrant	移民	n. 
immigrate	移入	v. 
immigration	移居入境	n. 
imminent	迫切的，危急的	adj. 
immoral	不道德的	adj. 
immortal	不朽的	adj. 
impact	冲击，影响	n. 
impart	给予，告诉	v. 
impartial	公证的	adj. 
impatience	不耐烦	n. 
impatient	急切的，不耐烦的	adj. 
imperative	绝对必要的	adj. 
imperfect	不完善的	adj. 
imperialism	帝国主义	n. 
imperialist	帝国主义者	n. 
implement	实行	v. 
implementation	实行，执行	n. 
implication	暗示，含义	n. 
implied	暗含的，暗示的	adj. 
implore	恳求，哀求	v. 
imply	暗示，意味	v. 
import	进口,引进	v. 
importance	重要性，意义	n. 
important	重要的，重大的	adj. 
importation	进口	n. 
importer	进口商	n. 
impose	征(税)，强加	v. 
imposition	强迫接受	n. 
impossibility	不可能性	n. 
impossible	不可能的，不妥的	adj. 
impost	进口税，关税	n. 
impractical	不可行的	v. 
impress	印，铭刻，产生印象	v. 
impression	印象，影响，印迹	n. 
impressive	给人深刻印象的	adj. 
imprison	关押，监禁	v. 
imprisonment	监禁，徒刑	n. 
improper	不适当的	adj. 
improve	改善，提高	v. 
improvement	改善，好转	n. 
impulse	冲击，冲动，脉搏	n. 
impurity	不纯，杂质	n. 
in	在...内，穿戴	prep. 
inability	无能	n. 
inaccessible	很难得到的	adj. 
inaccurate	不准确的，不确切	adj. 
inadequate	不充足的，不足以	adj. 
inasmuch	因为，由于	adv. 
inaugural	开幕的	adj. 
inaugurate	举行开幕、就职典礼	v. 
inauguration	开幕、就职典礼	n. 
incapable	不能的，不会的	adj. 
incense	使发怒	v. 
incentive	刺激的，鼓励的	n. 
inch	英寸	n. 
incident	事件，事变，插曲	n. 
incidentally	偶然地，另外	adv. 
inclination	倾斜，倾向	n. 
incline	低头，喜欢，倾斜	v. 
inclined	倾向于...的	adj. 
include	包括	v. 
inclusion	包括在内	n. 
inclusive	包括在内的	adj. 
income	收入，所得	n. 
incompatibility	不兼容	n. 
incompatible	不相容的	adj. 
incomplete	不完全的，没完成	adj. 
inconsistency	不一致	n. 
inconsistent	不一致的	adj. 
inconvenience	不便，不利	n. 
inconvenient	不方便的	adj. 
incorporate	合并，体现	v. 
incorporated	有限的	adj. 
incorrect	不正确的	adj. 
incoterms	(缩)国际贸易术语	n. 
increase	增加，增长	v. n. 
increasing	不断增长的	adj. 
increasingly	日益，越来越	adv. 
incredible	不可信的，惊人的	adj. 
incredulous	表示怀疑的	adj. 
increment	增值	n. 
incur	招致，承受	v. 
indebted	感激的，感恩的	adj. 
indebtedness	感激	n. 
indeed	的确，实际上	adv. 
indefinite	不明确的，不确定	adj. 
indefinitely	不明确地	adv. 
indemnify	赔偿，保护	v. 
indent	(书写)缩行	v. 
independence	独立，自主	n. 
independent	独立的	adj. 
independently	独立地	adv. 
index	索引，标志，指数	n. 
india	印度	n. 
indian	印度人(的)	adj. n. 
indicate	指明，表示	v. 
indication	表示，迹象	n. 
indicative	表示...的	adj. 
indifference	冷淡，不关心	n. 
indifferent	冷淡的，不在乎的	adj. 
indigestion	消化不良	n. 
indignant	气愤的，愤慨的	adj. 
indignation	愤慨，气愤	n. 
indirect	间接的，侧面的	adj. 
indirectly	间接地	adj. 
indispensable	必不可少的	adj. 
individual	个人的，各自的	adj. 
indoor	室内的	adj. 
indoors	在户内，在屋里	adv. 
induce	诱使，引起，归纳	v. 
inducement	诱导，动机	n. 
induction	感应，归纳	n. 
indulge	放纵，放任，纵容	v. 
industrial	工业的	adj. 
industrialization	工业化	n. 
industrialize	使工业化	v. 
industrialized	工业化的	adj. 
industrious	勤劳的，勤奋的	adj. 
industry	工业，产业，勤奋	n. 
ineffective	效率低的	adj. 
ineffectiveness	低效率	n. 
inefficiency	无效力	n. 
inefficient	无效的	adj. 
inertia	惯性，惰性，不活动	n. 
inevitable	必然的，不可避免	adj. 
inevitably	必然地	adv. 
inexpensive	便宜的	adj. 
infant	婴儿，幼儿	n. 
infantry	步兵	n. 
infect	感染，传染	v. 
infection	感染	n. 
infectious	传染的	adj. 
infer	推断，推论	v. 
inference	推断，推论的结果	n. 
inferior	低级的	adj. 
inferiority	劣势	n. 
infinite	无限大的，无穷的	adj. 
infinitely	无限地，无穷地	adv. 
infinitive	不定式的	adj. 
infinity	无限，无数，极多	n. 
inflammable	不易燃的	adj. 
inflation	充气，通货膨胀	n. 
inflict	打击	v. 
influence	影响，势力(范围)	n. 
influential	有影响的	adj. 
influenza	流行性感冒	n. 
inform	通知，告诉，告密	v. 
informal	非正式的	adj. 
information	通知，情报，资料	n. 
informative	提供资料的	adj. 
infrequent	不经常的	adj. 
infringe	侵权	v. 
infringement	侵权	n. 
ingenious	灵巧的，精巧的	adj. 
ingenious	独创的，机智的	adj. 
ingenuity	灵巧，机灵，巧妙	n. 
inhabit	居住，栖身	v. 
inhabitant	居民	n. 
inherent	生来俱有的	adj. 
inherit	继承，遗传	v. 
initial	最初的	adj. 
initially	最初	adv. 
initiate	发动，开始，使入门	v. 
initiative	积极性，首创精神	n. 
inject	注射	v. 
injection	注射	n. 
injure	伤害，损害	v. 
injury	伤害，损害	n. 
injustice	不公正	n. 
ink	墨水，油墨	n. 
inland	内地的，内陆的	n. 
inlet	水湾，入口	n. 
inn	客栈	n. 
inner	里面的，内心的	adj. 
innocence	清白，天真	n. 
innocent	无罪的	adj. 
innovate	革新，变革，创始	v. 
innovation	革新，创新	n. 
innumerable	无数的	adj. 
inorganic	无机的	adj. 
input	输入，投入	n. 
inquire	询问	v. 
inquiry	询问，查询，调查	n. 
insane	疯狂的	adj. 
insect	昆虫	n. 
insert	插入，嵌入	v. 
insertion	插入	n. 
inside	里面	n. 
insider	知情者	n. 
insight	洞察力	n. 
insignificant	无足轻重的	adj. 
insist	坚持，坚决要求	v. 
insistent	紧迫的，坚持的	adj. 
insofar	在...范围内	adv. 
insolvent	无偿付能力的	adj. 
inspect	检查，视察，审查	v. 
inspection	检查，视察	n. 
inspector	检查员，视察者	n. 
inspiration	灵感	n. 
inspire	鼓舞，激励，受启发	v. 
instable	不稳定的	adj. 
install	安装，安置	v. 
installation	安装，装置	n. 
installment	分期付款	n. 
instance	例子	n. 
instant	立即的，速溶的	adj. 
instantly	立即，立刻	adv. 
instead	代替，而是	adv. 
instinct	本能，直觉，天性	n. 
instinctive	本能的，天性的	adj. 
institute	(专科)学院	n. 
institution	机构，制度	n. 
instruct	指导，指示，告知	v. 
instruction	指导，指示	n. 
instructive	指示的，教育的	adj. 
instructor	教员，教练	n. 
instrument	仪器，乐器，手段	n. 
instrumental	仪器的，工具的	adj. 
insufficient	不充足的	adj. 
insulate	绝缘，隔离，使孤立	v. 
insulation	隔离，绝缘	n. 
insult	侮辱	v. adj. 
insurance	保险(业)，保障	n. 
insure	保险，确保	v. 
intangible	无形的	adj. 
integral	组成的，整体的	adj. 
integrate	整合，结合	v. 
integration	结合，整体	n. 
integrity	完整性，诚实	n. 
intellect	理智，才智	n. 
intellectual	知识分子	n. 
intelligence	智慧，情报	n. 
intelligent	聪明的，明智的	adj. 
intend	打算	v. 
intense	强烈的，极度的	adj. 
intensity	强烈，强度	n. 
intensive	强化的，密集的	adj. 
intent	意图	n. 
intention	意图，目的	n. 
intentional	有意的，故意的	adj. 
interact	相互作用，相互影响	v. 
interaction	相互作用	n. 
intercourse	交流，往来	n. 
interest	兴趣，利息，利益	n. 
interested	感兴趣的	adj. 
interesting	有趣的	adj. 
interface	交界，接口	n. 
interfere	妨碍，干涉	v. 
interference	干涉，干扰	n. 
interior	内部，内地，内政	n. 
intermediate	中间的	adj. 
internal	内部的，国内的	adj. 
international	国际的	adj. 
internationalization	国际化	n. 
internationalize	使国际化	v. 
interpret	解释，当...译员	v. 
interpretation	解释，口译	n. 
interpreter	译员	n. 
interrupt	打断，中断	v. 
interruption	中断，打扰	n. 
interval	间隔，中间休息	n. 
intervene	介入，调解	v. 
interview	会见，面谈	n. v. 
intimate	亲密的，熟悉的	adj. 
intimation	亲密，熟悉	n. 
into	到...里面	prep. 
intonation	语调，声调	n. 
introduce	介绍，引进，采用	v. 
introduction	介绍，引言	n. 
introductory	介绍的，入门的	adj. 
intrude	侵入，强加于	v. 
inundate	使充满	adj. 
invade	入侵，侵犯	v. 
invader	入侵者	n. 
invalid	伤残的，无效的	adj. 
invalidate	使无效	v. 
invaluable	非常宝贵的	adj. 
invariably	不变地，总是	adv. 
invasion	侵略，侵袭	n. 
invent	发明，创造，编造	v. 
invention	发明，创造	n. 
inventor	发明者	n. 
inverse	相反的，倒转的	adj. 
inversely	相反地	adv. 
invest	投资，花费	v. 
investigate	调查，研究	v. 
investigation	调查	n. 
investment	投资(额)	n. 
invisible	看不见的	adj. 
invitation	邀请(信)	n. 
invite	邀请，招致，征求	v. 
invoice	发票，装货清单	n. 
involve	使卷入，忙于	v. 
involved	涉及的，复杂的	adj. 
involvement	卷入，涉足	n. 
inward	里面的，内心的	adj. 
inwards	向内的	adv. 
ireland	爱尔兰	n. 
iron	铁，熨斗	n. 
ironical	反讽的，讽刺的	adj. 
irony	反讽，讽刺	n. 
irregular	不规则的	adj. 
irregularity	不规则	n. 
irresistible	不可抗拒的	adj. 
irrespective	不论，不考虑	adj. 
irrevocable	不可撤消的	adj. 
irrigate	灌溉	v. 
irrigation	灌溉	n. 
irritate	使生气，刺激	v. 
irritation	刺激，恼怒	n. 
islam	伊斯兰教，回教	n. 
island	岛屿	n. 
isolate	隔离，孤立	v. 
isolation	隔离，孤立状态	n. 
issue	发行,发布	v. 
it	它	pron. 
italian	意大利人(的)	n. adj. 
italy	意大利	n. 
itch	痒，热望	v. n. 
item	条款，项目	n. 
itemize	分列	v. 
its	它的	pron. 
itself	它自己	pron. 
ivory	象牙，象牙色	n. 
jack	千斤顶，船首旗	n. 
jacket	短外套，茄克衫	n. 
jail	监狱	n. 
jam	果酱，阻塞	n. 
january	一月	n. 
japan	日本	n. 
japanese	日本人(的)	n. adj. 
jar	罐子，坛子，刺耳声	n. 
jaw	下颚，下巴	n. 
jazz	爵士乐	n. 
jealous	妒忌的	adj. 
jealousy	妒忌	n. 
jeans	牛仔裤	n. 
jeep	吉普车	n. 
jelly	果冻	n. 
jeopardize	危及	v. 
jerk	颠簸，猛推	n. 
jesus	耶稣	n. 
jet	喷射	v. 
jettison	投弃货物	n. 
jew	犹太人	n. 
jewel	珠宝，宝石	n. 
jewelry	珠宝(总称)	n. 
jewish	犹太人的	adj. 
jingle	(发)叮当声	v. n. 
job	工作，活儿，差使	n. 
jobless	失业的	adj. 
jog	慢跑	v. 
join	连接，加入，参加	v. 
joint	接着，关节	n. 
joke	笑话	n. 
jot	匆匆记下	v. 
journal	刊物，日志	n. 
journalism	新闻体	n. 
journalist	记者	n. 
journey	旅行，旅程	n. 
joy	高兴，乐事	n. 
joyful	令人高兴的	adj. 
judge	法官，裁判	n. 
judgement	判决，意见，判断	n. 
jug	大壶，罐	n. 
juice	汁，液	n. 
juicy	多汁的	adj. 
july	七月	n. 
jumble	搞乱，混乱	n. 
jump	跳跃，跳动	v. n. 
junction	连接，结合处，接头	n. 
june	六月	n. 
jungle	密林，热带丛林	n. 
junior	年少的，低级的	adj. 
jupiter	木屋	n. 
jury	陪审团，评奖团	n. 
just	只，刚才	adv. 
justice	公正，正直	n. 
justifiable	有理由的	adj. 
justification	辩护，正当理由	n. 
justify	认为...有理	v. 
juvenile	青少年的	adj. 
kangaroo	带鼠	n. 
keen	锋利的，敏捷的	adj. 
keep	保持，保留，防止	v. 
keeper	保管人，管理员	n. 
keeping	一致，协调	n. 
kernel	核(仁)，核心	n. 
kerosene	煤油	n. 
kettle	水壶	n. 
key	钥匙，关键，答案	n. 
keyboard	键盘	n. 
keyhole	钥匙孔	n. 
kick	踢	v. n. 
kid	小孩	n. 
kidnap	绑架，诱拐	v. 
kidnaper	绑架者	n. 
kidney	肾，腰子	n. 
kill	杀死，杀害	v. 
killer	杀人者，杀手	n. 
kilo	(缩)公斤，公里	n. 
kilogram	公斤	n. 
kilometer	公里	n. 
kilowatt	千瓦	n. 
kind	种类	n. 
kindergarten	幼儿园	n. 
kindle	点燃，激发	v. 
kindly	仁慈地，好心地	adv. 
kindness	仁慈，好意	n. 
king	国王	n. 
kingdom	王国	n. 
kiss	接吻，亲嘴	v. 
kit	全套工具、装备	n. 
kitchen	厨房	n. 
kite	风筝	n. 
knee	膝	n. 
kneel	跪下	v. 
knife	小刀	n. 
knight	骑士，爵士	n. 
knit	编织，皱(眉)	v. 
knob	球形把手	n. 
knock	敲，击倒	v. 
knot	结，树节	n. 
know	知道，认识，懂	n. 
know-how	专项技术，诀窍	n. 
knowledge	知识，学识	n. 
knowledgeable	博学的	adj. 
l/c	(缩)信用证	n. 
lab	(缩)实验室	n. 
label	标签	n. 
labor	劳动，劳动力	n. 
laboratory	实验室	n. 
laborer	劳工，劳动者	n. 
labor-intensive	劳动密集型的	adj. 
lace	花边，鞋带	n. 
lack	缺少	v. n. 
lad	少年，小伙子	n. 
ladder	梯子，阶梯	n. 
lady	女士，贵妇人，夫人	n. 
lag	落后，滞后	v. n. 
lake	湖，湖泊	n. 
lamb	羔羊，小羊肉	n. 
lame	跛的，站不住脚的	adj. 
lamp	灯	n. 
land	陆地，土地	n. 
landed	卸货的	adj. 
landing	楼梯平台，着陆	n. 
landlady	女房东	n. 
landlord	房东，地主	n. 
landscape	风景(画)，地形	n. 
lane	小巷，跑道，行车道	n. 
language	语言	n. 
lantern	灯笼	n. 
lap	膝盖	n. 
lapse	(时间)流失	v. 
large	大的，巨大的	adj. 
largely	大部分，基本上	adv. 
lark	云雀，百灵鸟	n. 
laser	激光	n. 
last	最后的	adj. 
lasting	持久的，持续的	adj. 
late	迟到的，晚的	adj. 
lately	近来，最后	adv. 
latent	潜伏的，潜在的	adj. 
later	更晚，以后，过后	adv. 
lateral	横向的，侧向的	adj. 
lathe	车床	n. 
latin	拉丁语(的)	n. adj. 
latitude	纬度，活动余地	n. 
latter	后面的，后者的	adj. 
lattice	结构，点阵	n. 
laugh	笑，嘲笑	v. 
laughter	笑，笑声	n. 
launch	发射，发动，开始	v. 
laundry	洗衣店，送洗的衣物	n. 
lavatory	盥洗室，厕所	n. 
law	法律，定律	n. 
lawful	合法的，法律的	adj. 
lawn	草地，草坪	n. 
lawyer	律师，法学家	n. 
lay	放，安排，打基础	v. 
layday	装卸日期	n. 
layer	层，层次	n. 
layout	设计，规划，图案	n. 
laziness	懒惰	n. 
lazy	懒惰的	adj. 
lead	引导，领先，率领	v. 
leader	领导，领袖	n. 
leadership	领导	n. 
leading	领先的，一流的	adj. 
leaf	叶子，页	n. 
leaflet	传单，单页宣传品	n. 
league	同盟，协会	n. 
leak	漏，泄漏	v. 
leakage	渗漏	n. 
lean	俯身，倚	v. 
leap	跳跃	v. n. 
learn	学习，获悉	v. 
learned	有学问的	adj. 
learner	学习者，学生	n. 
learning	学问，学习	n. 
lease	租凭，出租	v. 
least	最少的	adj. 
leather	皮革	n. 
leave	出发，离开	v. 
lecture	演讲，讲课	n. v. 
lecturer	演讲者，讲师	n. 
leeway	活动余地	adj. 
left	左的	adj. 
left-handed	左手的，左侧的	adj. 
leftover	剩余物	n. 
leg	腿，裤脚	n. 
legal	合法的，法律的	adj. 
legend	传说，传奇	n. 
legendary	传说的，传奇的	adj. 
legislation	立法，法规	n. 
legitimate	合法的，合理的	adj. 
legitimation	合法	n. 
leisure	闲暇，闲空	n. 
lemon	柠檬	n. 
lemonade	柠檬汽水	n. 
lend	出借，贷款	v. 
lending	贷款，借款	n. 
length	长度，期限	n. 
lengthen	延长，变长	v. 
leninism	列宁主义	n. 
lens	透镜，镜片，晶体	n. 
leopard	豹	n. 
less	更少的	adj. 
lessen	减少，变小，变弱	v. 
lesson	功课，课程，教训	n. 
lest	唯恐，以免	prep. 
let	让，使	v. 
letter	字母，信，函件	n. 
level	水平，级	n. 
lever	杠杆	n. 
levy	征税	v. 
liability	责任，义务，债务	n. 
liable	有责任的	adj. 
liar	说谎者	n. 
liberal	思想开放的	adj. 
liberate	解放，释放，使自由	v. 
liberation	解放	n. 
liberty	自由	n. 
librarian	图书管理员	n. 
library	图书馆，藏书	n. 
license	许可(证)，执照	n. 
lick	舔	v. 
lid	盖，脸	n. 
lie	躺，位于	v. 
lieutenant	中尉，副职	n. 
life	生活，生命，一生	n. 
lifetime	一生	n. 
lift	举起，吊	v. 
light	光，灯	n. 
lighten	发亮，使...愉快	v. 
lighter	打火机	n. 
lighthouse	灯塔	n. 
lightly	轻轻地，轻易地	adv. 
lightning	闪电	n. 
like	喜欢	v. 
likelihood	可能，相似性	n. 
likely	可信的	adj. 
likeness	相像，类似	n. 
likewise	同样，照样	adv. 
liking	兴趣，嗜好	n. 
lily	百合，睡莲	n. 
limb	肢，树枝	n. 
lime	石灰	n. 
limestone	石灰岩	n. 
limit	界限，限度	n. 
limitation	限制，局限	n. 
limited	有限的，限定的	adj. 
limousine	豪华轿车	n. 
limp	柔软的	adj. 
line	行，线条，界线	n. 
linear	线性的，线状的	adj. 
linen	亚麻(织物)	n. 
liner	班轮，班机	n. 
linger	徘徊，逗留，拖延	v. 
linguist	语言学者	n. 
linguistics	语言学	n. 
lining	夹里，衬里	n. 
link	联系，连结	v. 
lion	狮子	n. 
lioness	母狮子	n. 
lip	嘴唇	n. 
lipstick	口红，唇膏	n. 
liquid	液体	n. 
liquor	烈性酒	n. 
list	表，名单	n. 
listen	听，听从	v. 
listener	听者	n. 
literacy	识字	n. 
literal	字面的，不夸张的	adj. 
literally	简直，字面上	adv. 
literary	文学的	adj. 
literate	有文化的	n. 
literature	文学，文献	n. 
litre	公升	n. 
litter	乱丢废物	v. 
little	小的，一点，少的	adj. 
live	居住,生存	v. 
livelihood	生活	n. 
lively	活跃的，热闹的	adj. 
liver	肝	n. 
livestock	牲畜	n. 
living	活着的	adj. 
living-room	客厅，起居室	n. 
load	负载，负担	n. 
loaf	面包	n. 
loan	贷款	n. 
lobby	前厅	n. 
lobster	龙虾	n. 
local	地方的，当地的	adj. 
locality	地点，现场	n. 
locate	找出，确定地点	v. 
location	地点，位置	n. 
lock	锁上	v. 
lock-up	锁，固定资本	n. 
locomotive	火车头，机车	n. 
locust	蝗虫	n. 
lodge	寄宿	v. 
lodging	住处，住房	n. 
lofty	崇高的，高耸的	adj. 
log	原木，航海日志	n. 
logic	逻辑，论理学	n. 
logical	逻辑的	adj. 
loneliness	孤独，寂寞	n. 
lonely	孤独的，寂寞的	adj. 
lonesome	寂寞的	adj. 
long	长的	adj. 
longevity	长寿	n. 
longing	渴望，思慕	n. 
longitude	经度，经线	n. 
long-term	长期的	adj. 
look	看，看上去	v. 
loom	隐隐出现	v. 
loop	环，回路	n. 
loose	松的，自由自在的	adj. 
loosen	解开，放松	v. 
lord	君主，贵族，上帝	n. 
lorry	卡车，载重汽车	n. 
lose	失去，丢失，输	v. 
loss	丧失，失利，损失	n. 
lost	失去的	adj. 
lot	许多，地	n. 
lottery	抽彩，抓阄，彩票	n. 
loud	响亮的，大声的	adj. 
loudness	响亮	n. 
loudspeaker	扬声器，扩音器	n. 
lounge	休息室	n. 
lovable	可爱的	adj. 
love	爱，喜欢	v. 
lovely	好看的，可爱的	adj. 
lover	爱人，情人，爱好者	n. 
low	低的，低廉的	adj. 
lower	降低，减弱	v. 
loyal	忠诚的，忠贞的	adj. 
loyalty	忠诚，忠贞	n. 
lubricate	润滑	v. 
lubrication	润滑	n. 
luck	运气，幸运	n. 
lucky	幸运的	adj. 
luggage	行李	n. 
lumber	木材，木料	n. 
luminous	发光的，明晰的	adj. 
lump	块，肿块	n. 
lumpsum	总数	n. 
lunar	月亮的，阴历的	adj. 
lunch	午饭，便餐	n. 
luncheon	午餐，午宴	n. 
lung	肺	n. 
luxurious	豪华的，奢侈的	adj. 
luxury	奢侈(品)	n. 
machine	机器	n. 
machinery	机械(总称)	n. 
mackintosh	雨衣	n. 
macroeconomics	宏观经济学	n. 
mad	疯狂的，狂热的	adj. 
madam	夫人，太太，女士	n. 
madman	疯子	n. 
madness	疯狂，疯病	n. 
magazine	杂志，期刊	n. 
magic	魔法，魔术，魅力	n. 
magician	魔术师	n. 
magistrate	地方法官	n. 
magnet	磁性，磁铁	n. 
magnetic	磁性的	adj. 
magnetism	磁性，磁力，吸引力	n. 
magnificent	壮丽的，宏伟的	adj. 
magnify	放大，扩大	v. 
magnitude	宏大，重要(性)	n. 
maid	女仆，侍女	n. 
maiden	少女	n. 
mail	邮件	n. 
mailbox	信箱	n. 
main	主要的	adj. 
mainland	大陆，本土	n. 
mainly	主要地，大部分	adv. 
mainstream	主流	n. 
maintain	维持，保养，坚持	v. 
maintenance	保养，维修	n. 
maize	玉米	n. 
majesty	陛下，雄伟，庄严	n. 
major	主要的，多数的	adj. 
majority	多数，过半数	n. 
make	做，制造	v. 
maker	制造者，制造商	n. 
make-shift	临时的	adj. 
make-up	气质，化妆品	n. 
malady	病	n. 
malaise	马来西亚	n. 
malaria	疟疾	n. 
malaysia	马来西亚	n. 
male	男性的，雄的	adj. 
malice	恶意，恶感	n. 
malicious	恶意的	adj. 
man	人，男人，人类	n. 
manage	管理，处理，设法	v. 
management	管理(人员)，经营	n. 
manager	经理	n. 
managerial	管理的	adj. 
manhood	男子气	n. 
manifest	表明	v. 
manifestation	表明	n. 
manifesto	宣言	n. 
manipulate	操纵，操作，摆布	v. 
manipulation	操纵，操作	n. 
mankind	人类	n. 
manly	大丈夫的	adj. 
manner	方法，方式，礼貌	n. 
mansion	宅第，官邸，大厦	n. 
manual	用手的	adj. 
manufacture	制造	v. n. 
manufactured	制成的	adj. 
manufacturer	制造商	n. 
manuscript	手稿，原稿	n. 
many	许多的	adj. 
map	地图	n. 
maple	枫树	n. 
marble	大理石，弹子	n. 
march	三月	n. 
march	行进，行军	n. v. 
margin	余地，边缘	n. 
marginal	边缘的，边际的	adj. 
marine	海的，海生的	adj. 
mariner	海员，水手	n. 
mark	痕迹，符号，标记	n. 
marked	有标记的，标明的	adj. 
market	市场，销路	n. 
marketable	有销路的	adj. 
marketing	市场学，营销学	n. 
marketplace	市场，集市	n. 
marking	唛头，标记	n. 
marriage	婚姻，婚礼	n. 
married	已婚的	adj. 
marry	娶，嫁，为...主婚	v. 
mars	火星	n. 
marsh	沼泽	n. 
marshal	元帅	n. 
martyr	烈士，殉道者	n. 
marvel	奇迹	n. 
marvellous	奇异的，绝妙的	adj. 
marxism	马克思主义	n. 
marxist	马克思主义者	n. 
masculine	男性的，阳性的	adj. 
mask	假面具	n. 
mass	堆，大量，群众	n. 
massacre	屠杀，残杀	n. v. 
massage	按摩，推拿	n. 
massive	粗大的，厚重的	adj. 
mast	桅杆	n. 
master	主人，大师，硕士	n. 
masterpiece	杰作	n. 
mat	垫子，席子	n. 
match	火柴，对手，比赛	n. 
mate	伙伴	n. 
material	材料，资料，原料	n. 
materialism	唯物主义	n. 
materialize	使具体化，物质化	v. 
mathematical	数学的	adj. 
mathematician	数字家	n. 
mathematics	数学	n. 
maths	(缩)数学	n. 
matinee	日场演出	n. 
matter	事情，物资，毛病	n. 
mattress	床垫	n. 
mature	成熟的，到期的	adj. 
maturity	成熟，到期	n. 
maximize	增加到最大程度	v. 
maximum	最大量，极限	n. 
may	五月	n. 
may	可以，也许，祝愿	v. 
maybe	或许，大概	adv. 
mayor	市长	n. 
me	我(宾格)	pron. 
meadow	牧场，草地	n. 
meal	膳食，一顿饭	n. 
mean	打算，意指	v. 
meaning	意义，意图	n. 
means	手段，财力	n. 
meantime	同时，在这期间	adv. 
meanwhile	在这期间	adv. n. 
measure	尺寸，量具，措施	n. 
measurement	测量(结果)	n. 
meat	肉	n. 
mechanic	技工	n. 
mechanical	机械的、机动的	adj. 
mechanically	机械地	adv. 
mechanics	力学，机械学	n. 
mechanism	机制，机械装置	n. 
medal	奖章，勋章，纪念章	n. 
medical	医学的，医务的	adj. 
medicine	药，医学	n. 
medieval	中世纪的	adj. 
meditate	考虑，沉思	v. 
meditation	考虑，沉思冥想	n. 
mediterranean	地中海	n. 
medium	中间，媒介，中庸	n. 
meek	温顺的	adj. 
meet	遇到，会见，迎接	v. 
meeting	会议，集会	n. 
melancholy	忧郁(的)	n. adj. 
melody	旋律，曲调	n. 
melon	瓜，甜瓜	n. 
melt	熔化，融解	v. 
member	成员，会员	n. 
membership	会员资格，全体成员	n. 
memo	备忘录	n. 
memoir	回忆录	n. 
memorial	纪念的，追悼的	adj. 
memorize	记住，记忆	v. 
memory	记忆(力)，回忆	n. 
menace	威胁，恐吓	v. n. 
mend	修理，修补，好转	v. 
mental	心理的，精神的	adj. 
mentality	心理，意识	n. 
mention	提及，讲到	v. n. 
menu	菜单	n. 
mercantile	商品	n. 
merchandise	商品，货物	n. 
merchant	商人	n. 
merciful	仁慈的，宽大的	adj. 
mercury	水星	n. 
mercury	汞，水银	n. 
mercy	宽大，慈悲，怜悯	n. 
mere	仅仅的，起码的	adj. 
merely	仅仅，只	adv. 
merge	合并	v. 
merit	价值，功绩	n. 
mermaid	美人鱼	n. 
merry	欢乐的	adj. 
mesh	网孔，筛眼	n. 
mess	肮脏，凌乱	n. 
message	音讯，消息	n. 
messenger	通讯员，使者	n. 
metal	金属	n. 
metallic	金属的	adj. 
metallurgy	冶金学	n. 
meter	量器，仪表	n. 
method	方法	n. 
methodology	方法(论)	n. 
meticulous	小心翼翼的	adj. 
meticulously	胆小地	adv. 
metre	米，公尺	n. 
metric	公制的，米的	adj. 
metropolitan	大都市	n. 
mexican	墨西哥人(的)	n. adj. 
mexico	墨西哥	n. 
microeconomics	微观经济学	n. 
microphone	扩音器，话筒	n. 
microprocessor	微处理机	n. 
microscope	显微镜	n. 
microwave	微波	n. 
midday	正午，晌午	n. 
middle	当中	n. 
middleman	中人，中间人	n. 
middling	中等的，第二流的	n. 
midnight	午夜	n. 
midst	中间，中部	n. 
might	或许，可以	v. 
mighty	强有力的	adj. 
migrant	迁移的，候鸟的	adj. 
migrate	迁移(海外)，移栖	v. 
migration	迁移，移居海外	n. 
mild	温和的，味淡的	adj. 
mile	英里	n. 
mileage	里程	n. 
milestone	里程碑	n. 
military	军事的，好斗的	adj. 
militia	民兵(组织)	n. 
milk	奶，乳夜	n. 
milkman	送奶人	n. 
milky	加奶的，乳白色的	adj. 
mill	磨坊，工厂	n. 
miller	磨坊主	n. 
millimetre	毫米	n. 
million	百万	n. 
millionaire	百万富翁	n. 
mince	切碎，绞碎	v. 
mincer	粉碎机	n. 
mind	头脑，智力	n. 
mine	我的	pron. 
miner	矿工	n. 
mineral	矿物	n. 
mingle	混合，混入	v. 
miniature	雏形，缩影，袖珍	n. 
minicomputer	微型计算机	n. 
minimize	使减到最小	v. 
minimum	最少量	n. 
minister	教士，部长，大臣	n. 
ministry	(政府)部	n. 
minor	较小的，次要的	adj. 
minority	少数，少数民族	n. 
mint	造币厂，薄荷	n. 
minus	减去	prep. 
minute	分钟，片刻	n. 
miracle	奇迹，令人惊讶的事	n. 
miraculous	奇迹(般)的	adj. 
mirror	镜子	n. 
miscarriage	未到目的地	n. 
miscarry	未运到(目的地)	v. 
mischief	伤害，恶作剧	n. 
miser	吝啬鬼，守财奴	n. 
miserable	悲惨的，糟糕的	adj. 
misery	痛苦，悲惨，苦难	n. 
misfortune	不幸	n. 
misgiving	疑虑，担心	n. 
mishandle	装卸不慎	v. 
mishap	事故	n. 
misinterpret	误解	v. 
mislead	引入岐途	v. 
miss	未击中,错过	v. 
missile	导弹，发射物	n. 
missing	丢失的，缺少的	adj. 
mission	使团，使命，天职	n. 
missionary	传教士	n. 
mist	薄雾	n. 
mistake	错误，误解	n. 
mistaken	搞错了的，误解的	adj. 
mister	先生(缩写为Mr.)	n. 
mistress	女主人，情妇	n. 
misty	雾蒙蒙的，有雾的	adj. 
misunderstand	误解，误会	v. 
misunderstanding	误会，曲解	n. 
mitten	连指手套，露指手套	n. 
mix	混合，配料，交往	v. 
mixer	混合器	n. 
mixture	混合物，混和	n. 
moan	呻吟，悲叹	v. n. 
mob	暴民，乌合之众	n. 
mobile	机动的，流动的	adj. 
mobilize	动员	v. 
mock	嘲笑，愚弄	v. 
mode	方式，方法	n. 
model	模范，模型，模特儿	n. 
moderate	适度的	adj. 
moderately	适度地，适中地	adv. 
modern	现代的，时髦的	adj. 
modernization	现代化	n. 
modernize	使...现代化	v. 
modest	谦虚的，质朴的	adj. 
modesty	谦虚	n. 
modification	修改，缓和	n. 
modified	改良的，改进的	adj. 
modify	修改，减轻，修饰	v. 
modulate	调整，改变	v. 
module	模量，模件	n. 
moist	潮湿的	adj. 
moisture	潮气	n. 
molecular	分子的	adj. 
molecule	分子	n. 
moment	时刻，瞬间	n. 
momentary	片刻的，瞬间的	adj. 
momentous	重要的，重大的	adj. 
monarch	君主，王室	n. 
monastery	修道院，寺院	adj. 
monday	星期一	n. 
monetary	货币的，金融的	adj. 
money	金钱，货币，财富	n. 
monitor	班长,监视器	n. 
monk	和尚，修道士	n. 
monkey	猴子	n. 
monopolize	垄断，独占	v. 
monopoly	垄断，独占	n. 
monotonous	单调的，枯燥的	adj. 
monotony	单调，枯燥	n. 
monster	怪兽，怪物，魔鬼	n. 
monstrous	可怕的，极恶的	adj. 
month	月份	n. 
monthly	每月的	adj. 
monument	纪念章，不朽之物	n. 
monumental	纪念碑式的	adj. 
mood	心情，心境，情绪	n. 
moon	月亮	n. 
moonlight	月光	n. 
moonlighting	业余干活	n. 
moor	系泊，把船栓定	v. 
mop	拖把，墩布	n. 
moral	道德的	adj. 
morale	士气，斗志	n. 
morality	道德品质	n. 
more	更多的,更	adj. 
moreover	此外，而且	adv. 
morning	早晨，上午	n. 
mortal	致命的	adj. 
moslem	穆斯林	n. adj. 
mosque	清真寺	n. 
mosquito	蚊子	n. 
moss	苔藓，地衣	n. 
most	最多的	adj. 
mostly	主要地，大多	adv. 
motel	汽车旅馆	n. 
moth	蛾	n. 
mother	母亲	n. 
mother-in-law	岳母，婆婆	n. 
motion	运动，议案	n. 
motionless	不动的	adj. 
motivate	促进，激发	v. 
motivation	动机	n. 
motive	动机	n. 
motor	发动机	n. 
motorcar	汽车	n. 
motorcycle	摩托车	n. 
motorist	摩托车手	n. 
motorway	汽车道，高速公路	n. 
motto	座右铭	n. 
mould	模子，型，霉菌	n. 
mount	山，岳	n. 
mountain	山	n. 
mountainous	多山的，山一般的	adj. 
mourn	悲悼，哀痛	v. 
mournful	悲悼的，哀痛的	adj. 
mourning	哀痛	n. 
mouse	老鼠	n. 
moustache	胡子，须	n. 
mouth	口，嘴巴，河口	n. 
mouthful	一口，满口	n. 
move	移动，推动，搬家	v. 
movement	活动，运动，动作	n. 
movie	电影(院)	n. 
much	许多的	adj. 
mud	泥浆	n. 
muddy	泥泞的	adj. 
muffle	裹住，捂住	v. 
muffler	围巾，消音器	n. 
mug	(有柄)大杯	n. 
mule	骡子	n. 
multifunction	多功能的	n. 
multiple	复合的，多次方的	adj. 
multiplication	乘法，增加	n. 
multiply	乘，增加，繁殖	v. 
multitude	大批，大群	n. 
mumble	咕哝，嘟囔	v. 
mumps	腮腺炎	n. 
municipal	市的，市政的	adj. 
murder	谋杀(案)	v. n. 
murderer	凶手，杀人犯	n. 
murmur	低声说	v. 
muscle	筋，肌肉	n. 
muscular	肌肉发达的	adj. 
muse	沉思，默想	v. 
museum	博物馆，陈列馆	n. 
mushroom	“蘑菇	n. 
music	音乐，乐曲	n. 
musical	音乐的	adj. 
musician	音乐家，作曲家	n. 
must	必须，准是	v. 
mustard	芥末	n. 
mute	缄默的	adj. 
mutter	咕哝，抱怨	v. 
mutton	羊肉	n. 
mutual	相互的，共同的	adj. 
my	我的	pron. 
myriad	无数(的)	n. adj. 
myself	我自己，我亲自	pron. 
mysterious	神秘的，玄妙的	adj. 
mystery	神秘，奥妙，秘事	n. 
mystic	神秘的	adj. 
myth	神话	n. 
mythology	神话(学)	n. 
nail	钉子，指甲	n. 
naive	天真的	adj. 
naked	裸体的，赤裸裸的	adj. 
name	姓名，名称	n. 
nameless	无名的	adj. 
namely	即，也就是	adv. 
namesake	名义	n. 
nap	打盹，小睡	n. 
napkin	餐巾(纸)	n. 
narrate	叙述	v. 
narration	叙述	n. 
narrator	叙述者	n. 
narrow	狭窄的，勉强的	adj. 
nasty	肮脏的，下流的	adj. 
nation	国家，国民，民族	n. 
national	民族的，国家的	adj. 
nationality	国籍	n. 
native	本国的，出生地的	adj. 
natural	自然的，通常的	adj. 
naturally	自然地	adv. 
nature	自然，本性，性质	n. 
naughty	淘气的，顽皮的	adj. 
nausea	恶心，讨厌	v. 
naval	海军的	adj. 
navel	脐，中心	n. 
navigable	可航行的	adj. 
navigation	航行，航海，航空	n. 
navy	海军	n. 
near	近	adv. 
nearby	附近(的)	adj. adv. 
nearly	几乎，差不多	adv. 
neat	整洁的，简洁的	adj. 
necessarily	必然，当然	adv. 
necessary	必要的，必然的	adj. 
necessitate	使需要，强迫	v. 
necessity	必要性，必须品	n. 
neck	颈，脖子	n. 
necklace	项链	n. 
need	需要，贫困	n. 
needful	必要的	adj. 
needle	针，指针，针叶	n. 
needless	不必要的，无用的	adj. 
needy	贫穷的	adj. 
negate	否定	v. 
negation	否定	n. 
negative	否定的	adj. 
neglect	疏忽，忽视	v. n. 
negligence	疏忽，过失	n. 
negligent	粗心大意的	adj. 
negligible	微不足道的	adj. 
negotiable	可谈判的	adj. 
negotiate	谈判，交涉	v. 
negotiation	谈判	n. 
negro	黑人(贬义)	n. 
neighbor	邻居，邻国	n. 
neighborhood	邻里，街坊	n. 
neighboring	邻近的，相邻的	adj. 
neither	既不...又不...	conj. 
nephew	侄子，外甥	n. 
nerve	神经，胆量	n. 
nervous	神经(质)的，	adj. 
nest	巢，窝	n. 
nestle	安顿，建巢	v. 
net	网	n. 
network	网络，网状组织	n. 
neutral	中立的，中和的	adj. 
neutrality	中立	n. 
neutron	中子	n. 
never	从不，永不，未曾	adv. 
nevertheless	还是，然而	adv. 
new	新的，重新的	adj. 
news	新闻，消息	n. 
newspaper	报纸，新闻纸	n. 
next	下一次，然后	adv. 
nice	令人愉快的	adj. 
nickel	镍，镍币	n. 
nickname	绰号，诨号	n. 
niece	侄女，外甥女	n. 
night	夜，黑夜	n. 
nightgown	睡衣	n. 
nightingale	夜莺	n. 
nightmare	恶梦	n. 
nine	九	num. 
nineteen	十九	num. 
ninety	九十	num. 
ninth	第九，九分之一	num. 
nitrogen	氮	n. 
no	不,毫不	adv. 
nobility	高贵，庄严	n. 
noble	高尚的，贵族的	adj. 
nobody	谁也不	prep. 
nod	点头	v. n. 
noise	噪音，吵嚷声	n. 
noisy	吵闹的	adj. 
nominal	名义上的，票面的	adj. 
nominate	提名，推荐，任命	v. 
nomination	提名，任命	n. 
none	没人，毫无	prep. 
nonsense	废话，谬论	n. 
noon	中午，正午	n. 
nor	也不，也没	conj. 
norm	标准，规范，定额	n. 
normal	正常的，标准的	adj. 
normalization	正常化	n. 
normalize	使正常，使标准化	v. 
normally	正常地，通常	adv. 
north	北，北方	n. 
northeast	东北(的)	adj. n. 
northern	北方的，北部的	adj. 
northward	向北(的)	adj. adv. 
northwest	西北(的)	adj. n. 
nose	鼻子	n. 
nostril	鼻孔	n. 
not	不	adv. 
notable	值得注意的	adj. 
notably	尤其，值得注意地	adj. 
note	笔记，注释，便条	n. 
notebook	笔记本	n. 
noted	著名的	adj. 
note-taking	笔记，笔录	n. 
nothing	没有东西	n. 
notice	留意	v. 
noticeable	显而易见的	adj. 
notification	通知(书)，布告	n. 
notify	通知，通告，报告	v. 
notion	概念，意见，看法	n. 
notorious	臭名昭著的	adj. 
notwithstanding	尽管	prep. 
nought	零	n. 
noun	名词	n. 
nourish	养育，提供养分	v. 
nourishment	食物，补品	n. 
novel	新颖的	adj. 
novelette	中篇小说	n. 
novelist	小说家	n. 
novelty	新奇，新颖	n. 
november	十一月	n. 
now	现在	adv. 
nowadays	现今，目前	adv. 
nowhere	哪儿也不	adv. 
nuclear	核的，原子核的	adj. 
nucleus	(原子)核，核心	n. 
nuisance	令人讨厌的人或事	n. 
null	无	n. 
nullify	使无效，取消	v. 
number	数字，若干，号码	n. 
numerical	数字的	adj. 
numerous	众多的，大量的	adj. 
nun	修女，尼姑	n. 
nurse	护士，保姆	n. 
nursery	托儿所，苗圃	n. 
nut	坚果，螺母	n. 
nylon	尼龙	n. 
oak	橡树，栎树	n. 
oar	橹，桨	n. 
oath	誓言，誓约	n. 
obedience	服从，顺从	n. 
obedient	服从的，顺从的	adj. 
obey	服从，遵守	v. 
object	物体，目的	n. 
objection	反对，异议，不愿	n. 
objective	目标	n. 
obligation	义务，责任	n. 
oblige	责成，使感激	v. 
obliterate	删去，抹掉	adj. 
oblong	椭圆形的	adj. 
obscure	无名的	adj. 
observance	仪式，习惯	n. 
observation	观察，评述	n. 
observe	观察，遵守，注视	v. 
observer	观察员	n. 
obstacle	障碍(物)	n. 
obstinate	固执的，顽强的	adj. 
obstruction	堵塞，妨碍	n. 
obtain	获得	v. 
obtainable	可得到的	adj. 
obvious	明显的	adj. 
obviously	明显地，显然	adv. 
occasion	场合，盛事，机会	n. 
occasional	偶然的，有时的	adj. 
occasionally	偶而，有时	adv. 
occident	西方	n. 
occidental	西方的，西洋的	adj. 
occupation	职业，占有	n. 
occupy	占据，占领，担任	v. 
occur	发生，出现，想到	v. 
occurrence	发生，出现，事件	n. 
ocean	海洋，大洋	n. 
oceania	大洋洲	n. 
oceanography	海洋学	n. 
o'clock	点钟	adv. 
october	十月	n. 
odd	古怪的，奇数的	adj. 
odour	气味	n. 
of	的(表示领属等)	prep. 
off	去	adv. 
off-duty	不当班的	adj. 
offence	过错，冒犯，攻击	n. 
offend	冒犯，得罪	v. 
offensive	冒犯的，攻击的	adj. 
offer	提供，报盘	v. n. 
offering	报盘，提供的货物	n. 
off-grade	等外的，质差的	adj. 
office	办公室，事务所	n. 
officer	军官，警官，官员	n. 
official	官员	n. 
offset	抵消，弥补	v. 
offspring	子女，子孙	n. 
often	经常，常常	adv. 
oh	哦，嗬	int. 
oil	油，石油	n. 
old	老的，...岁的	adj. 
olive	橄榄(树)	n. 
omen	前兆	n. 
ominous	不祥的	adj. 
omission	省略	n. 
omit	省略，遗漏	v. 
on	在...上，关于	prep. 
once	一度，一次	adv. 
one	一，一个	num. 
oneself	自己，自身	pron. 
onion	洋葱	n. 
only	唯一的	adj. 
onset	攻击，着手	n. 
onto	到...上	prep. 
onward	向前(的)	adv. adj. 
opal	蛋白石	n. 
opaque	不透明的	adj. 
open	开的	adj. 
opener	开罐器，起子	n. 
opening	开始，通路，孔	n. 
opera	歌剧	n. 
operate	运转，操作，开刀	v. 
operation	操作，生效，手术	n. 
operational	业务上的，操作的	adj. 
operative	有效的	adj. 
operator	操作人员，接线员	n. 
opinion	意见，评论，看法	n. 
opium	鸦片	n. 
opponent	对手，敌手	n. 
opportune	及时的，凑巧的	adj. 
opportunity	机会，机遇，时机	n. 
oppose	反对，反抗	v. 
opposite	对立的，对面的	adj. 
opposition	敌对，反抗	n. 
oppress	压抑，压迫，压制	v. 
oppression	压迫	n. 
optical	视觉的，光学的	adj. 
optimal	最佳的	adj. 
optimism	乐观(主义)	n. 
optimistic	乐观(主义)的	adj. 
optimize	最佳化	v. 
optimum	最佳条件	n. 
option	选择，可选择的东西	n. 
optional	可任选的，随意的	adj. 
or	或者，即，否则	conj. 
oral	口头的，口的	adj. 
orange	柑桔，橙色	n. 
orbit	轨道	n. 
orchard	果园	n. 
orchestra	管弦乐队，交响乐	n. 
order	命令，订货，次序	n. 
orderly	整齐的	adj. 
ordinarily	通常	adv. 
ordinary	普通的，一般的	adj. 
ore	矿石，矿物	n. 
organ	器官，风琴	n. 
organic	器官的，有机的	adj. 
organism	有机体	n. 
organization	组织，团体	n. 
organizational	组织的	adj. 
organize	组织，筹备，编排	v. 
orient	东方	n. 
oriental	东方的(人)	adj. n. 
orientation	定向，倾向性	n. 
origin	起源，产地	n. 
original	原始的	adj. 
originality	独创性	n. 
originally	原来，当初	adv. 
originate	起源，首创	v. 
ornament	装饰(品)	n. 
ornamental	装饰的	adj. 
orphan	孤儿	n. 
oscillation	摆动，振动	n. 
other	其他的，别的	adj. 
otherwise	另外的	adv. 
ought	应该，大概	v. 
ounce	盎司	n. 
our	我们的	pron. 
ourselves	我们自己	pron. 
out	出外，向外，完	adv. 
outbreak	爆发，发作	n. 
outcome	结果	n. 
outdoor	野外的，露天的	adj. 
outdoors	在外的，在野外的	adv. 
outer	外部的，外面的	adj. 
outermost	最外的	adj. 
outland	偏僻地区	n. 
outlandish	外国的	adj. 
outlaw	逃犯，歹徒	n. 
outlay	费用，支出	n. 
outlet	出口，销路	n. 
outline	轮廓，略图，大纲	n. 
outlook	看法，景色，展望	n. 
output	出产，产量	n. 
outrage	暴行	n. 
outrageous	残暴的	adj. 
outright	公然地，直率地	adj. 
outset	开头，起初	n. 
outside	外部	n. 
outsider	局外人	n. 
outskirts	郊区	n. 
outstanding	杰出的，未付款的	adj. 
outturn	卸货情况	n. 
outward	向外(的)	adj. adv. 
oval	椭圆(形)的	adj. 
oven	烤炉，锅灶	n. 
over	在...上方，越过	prep. 
overall	总的，全面的	adj. 
overcast	多云的	adj. 
overcharge	多收(的)钱	v. n. 
overcoat	外套，大衣	n. 
overcome	征服，克服，压倒	v. 
overestimate	估计过高	v. 
overextend	使...承担过多的义务	v. 
overflow	泛滥，溢出，满怀	v. 
overhead	头上(的)	adv. adj. 
overhear	偶然听到，偷听	v. 
overjoy	使大喜	n. 
overlap	重叠	v. 
overlapping	相互重叠的	adj. 
overload	超载	v. n. 
overlook	视察，俯瞰，宽容	v. 
overnight	终夜(的)	adv. adj. 
overpayment	多付的款项	n. 
overseas	海外(的)	adv. adj. 
oversight	监视，疏忽	n. 
overtake	赶上，压倒	v. 
overthrow	推翻，颠覆	v. 
overtime	超时，加班	n. 
overwhelm	压倒，淹没	v. 
overwhelming	压倒的	adj. 
owe	欠，归功于	v. 
owing	该付的	adj. 
owl	猫头鹰	n. 
own	自己的	adj. 
owner	物主，所有人	n. 
ownership	所有权，所有制	n. 
ox	公牛	n. 
oxide	氧化物	n. 
oxygen	氧，氧化	n. 
oyster	牡蛎，蚝	n. 
pace	步，速度，步调	n. 
pacific	太平洋	n. 
pack	包装，挤满	v. 
package	包裹	n. 
packaging	包装	n. 
packet	一盒，小件包裹	n. 
packing	装箱，收拾行李	n. 
pad	垫，便笺本	n. 
page	(书)页	n. 
pail	提桶	n. 
pain	疼痛，悲痛	n. 
painful	痛苦的	adj. 
paint	涂料，油漆	n. 
painter	画家，油漆匠	n. 
painting	画，绘画(艺术)	n. 
pair	对，双，夫妇	n. 
palace	宫殿	n. 
pale	苍白的，淡的	adj. 
palm	手掌，掌心，棕榈树	n. 
pamphlet	小册子	n. 
pan	平底锅	n. 
panda	熊猫	n. 
pane	窗(门)玻璃	n. 
panel	镶板，仪表盘，小组	n. 
panic	恐慌，惊慌	n. v. 
panorama	全景	n. 
panoramic	全景的	adj. 
pant	喘气	n. v. 
panther	豹，美洲豹	n. 
pantry	配膳室，食品室	n. 
pants	长裤，衬裤	n. 
paper	纸，报纸，文件	n. 
papercut	剪纸，刻纸	n. 
papercutting	剪纸艺术	n. 
papers	文件，证书	n. 
par	(跟)原价相等	n. 
parachute	降落伞	n. 
parade	游行	n. v. 
paradise	天堂，天国	n. 
paragraph	段落，节	n. 
parallel	平行的，类似的	adj. 
paralyse	使麻痹，惊呆	v. 
parameter	参数，参量	n. 
parasite	寄生虫，寄生物	n. 
parcel	包裹，邮包	n. 
pardon	原谅，赦免	n. v. 
parent	父或母亲，母体	n. 
paris	巴黎	n. 
parish	教区	n. 
park	公园	n. 
parking	停放车辆	n. 
parliament	议会，国会	n. 
parlimental	国会的，议会的	adj. 
parlor	客厅	n. 
parrot	鹦鹉	n. 
part	部分，零件，角色	n. 
partial	局部的，偏颇的	adj. 
partially	局部地，部分地	adv. 
participant	参加者，参与者	n. 
participate	参与，分享	v. 
participation	参加，参与	n. 
particle	颗粒，微粒，虚词	n. 
particular	特殊的	adj. 
particularly	特别地	adv. 
partition	划分，隔开	v. n. 
partly	部分地	adv. 
partner	伙伴，合伙人，搭档	n. 
partnership	伙伴关系，合伙	n. 
part-time	计时(干活)的	adj. 
party	聚会，政党，一方	n. 
pass	经过，传给	v. 
passable	过得去的	adj. 
passage	一段，通过，通道	n. 
passenger	旅客，乘客	n. 
passion	激情，热衷	n. 
passionate	多情的，热烈的	adj. 
passive	被动的，消极的	adj. 
passport	护照	n. 
past	过去的	adj. 
past-due	过期的	adj. 
paste	浆糊，糊状物	n. 
pastime	消谴，娱乐	n. 
pasture	牧场	n. 
pat	轻拍，抚摸	n. v. 
patch	补丁，眼罩	n. 
patent	专利权，专利证	n. 
path	小径，路线	n. 
pathetic	凄婉动人的	adj. 
patience	耐心，忍耐力	n. 
patient	耐心的	adj. 
patriot	爱国者	n. 
patriotic	爱国的	adj. 
patriotism	爱国主义	n. 
patrol	巡逻	v. 
patron	赞助人，保护人	n. 
patronage	保护人身分	n. 
pattern	模式，式样，图案	n. 
pause	暂停，中止	v. n. 
pave	铺路，为...铺平道路	v. 
pavement	人行道	n. 
paw	脚瓜	n. 
pawn	产卵	v. 
pay	支付	v. 
payable	支付给...的	adj. 
payment	支付，付款	n. 
pea	豌豆	n. 
peace	和平，平静，和约	n. 
peaceful	和平的，平静的	adj. 
peach	桃子	n. 
peacock	孔雀	n. 
peak	顶点，巅，山峰	n. 
peanut	花生	n. 
pear	梨	n. 
pearl	珍珠	n. 
peasant	农民	n. 
peasantry	农民(总称)	n. 
pebble	鹅卵石	n. 
peck	啄	v. 
peculiar	古怪的，独特的	adj. 
peculiarity	特性，怪癖	n. 
pedal	踏板	n. 
pedestrian	行人	n. 
pedlar	小贩	n. 
peel	果皮	n. 
peep	偷看，窥视	v. 
peer	同行	n. 
peg	桩	n. 
pen	钢笔，栏，圈	n. 
penalty	刑罚，处罚，罚款	n. 
pencil	铅笔	n. 
pending	未决的，紧迫的	adj. 
penetrate	贯穿，穿透，弥漫	v. 
penetration	贯穿，洞察力	n. 
penicillin	青霉素，盘尼西林	n. 
peninsular	半岛	n. 
penny	便士	n. 
pension	养老金，年金	n. 
people	人们，人民，人员	n. 
pepper	胡椒	n. 
per	每，由，按照	prep. 
perceive	知觉，觉察，领悟	v. 
percent	每百，百分之	n. 
percentage	百分率	n. 
perception	感觉，理解力	n. 
perch	栖息	v. 
perfect	完美的，完备的	adj. 
perfection	完成，完善	n. 
perfectly	完全地，完美地	adv. 
perform	执行，表演	v. 
performance	执行，演出	n. 
performer	执行者，表演者	n. 
perfume	香味，香水	n. 
perhaps	也许，多半	adv. 
peril	危难，巨大危险	n. 
perimeter	周长	n. 
period	时期，句号	n. 
periodic	周期的，定时的	adj. 
periodical	期刊	n. 
peripheral	边缘的，周边的	adj. 
perish	死亡，枯萎	v. 
permanence	永久，持久	n. 
permanent	永久性的，持久的	n. 
permanently	永久地	adv. 
permission	允许，许可	n. 
permissive	允许的，许可的	adj. 
permit	允许	v. 
perpendicular	垂直的	adj. 
perpetual	永久的，永恒的	adj. 
perplex	迷惑，难住	v. 
persecute	迫害	v. 
persecution	迫害	n. 
perseverance	坚持	n. 
persevere	坚持	v. 
persist	坚持，固执，持续	v. 
persistence	坚持，持续	n. 
person	人，人称，身体	n. 
personal	私人的，个人的	adj. 
personality	人格，个性，人物	n. 
personally	亲自，就个人而言	adv. 
personnel	全体人员，人事部门	n. 
perspective	展望，观点，透视	n. 
persuade	说服，劝导	v. 
persuasion	说服，信念	n. 
pertain	属于	v. 
pertinence	中肯	n. 
pertinent	中肯的，恰当的	adj. 
perturb	扰乱	v. 
perturbed	烦燥不安的	adj. 
perusal	细读	n. 
peruse	仔细阅读，审查	v. 
pessimist	悲观(主义)	n. 
pessimistic	悲观的	adj. 
pest	害虫	n. 
pet	爱畜，宠儿	n. 
petition	请愿(书)	v. n. 
petrol	石油，汽油	n. 
petroleum	石油	n. 
petty	细小的，不重要的	adj. 
phase	阶段，时期，侧面	n. 
phenomenon	现象，非凡的人	n. 
philosopher	哲学家	n. 
philosophical	哲学上的	adj. 
philosophy	哲学，基本原则	n. 
phone	电话	n. 
phonetics	语音学	n. 
photo	照片	n. 
photograph	照片	n. 
photographer	摄影师	n. 
photography	摄影术	n. 
photostatic	静电复印的	adj. 
phrase	词组，短语	n. 
physical	身体的，物质的	adj. 
physically	物质上，身体上	adv. 
physician	内科医生	n. 
physicist	物理学家	n. 
physics	物理学	n. 
pianist	钢琴家	n. 
piano	钢琴	n. 
pick	拣，采	v. 
pickle	腌渍品，泡菜	n. 
pickpocket	扒手，小偷	n. 
picnic	郊游，野餐	n. v. 
pictorial	画报	n. 
picture	图片，画，照片	n. 
picturesque	风景如画的	adj. 
pie	馅饼	n. 
piece	件，片段，张	n. 
pier	码头，栈桥	n. 
pig	猪	n. 
pigeon	鸽子	n. 
pigment	色料	n. 
pile	堆	n. 
pilferage	偷窃	v. 
pilgrim	香客，朝圣者	n. 
pilgrimage	朝圣	n. 
pill	药片，药丸	n. 
pillar	柱子	n. 
pillow	枕头	n. 
pilot	飞行员，领航员	n. 
pin	别针，发卡	n. 
pinch	捏，掐，挤痛	v. 
pine	松树	n. 
pineapple	菠萝	n. 
pink	桃色，粉红色	adj. n. 
pint	品脱(容量单位)	n. 
pioneer	先驱者	n. 
pioneering	先驱的	n. 
pious	虔诚的	adj. 
pipe	管子，烟斗	n. 
pipeline	管道，管线	n. 
pirate	海盗	n. 
pistol	手枪	n. 
piston	活塞	n. 
pit	坑，洼，煤矿，桃核	n. 
pitch	搭帐篷，投掷	v. 
pitcher	水罐	n. 
pity	怜悯，惋惜，憾事	n. 
place	地方，位置	n. 
plague	瘟疫	n. 
plain	明白的，朴素的	adj. 
plan	计划,平面图	n. 
plane	水平，平面，飞机	n. 
planet	行星	n. 
plant	植物，工厂	n. 
plantation	种植园	n. 
plaster	灰泥	n. 
plastic	塑料	n. 
plastics	塑料(制品)	n. 
plate	盘子，金属牌	n. 
plateau	高原，高地	n. 
platform	讲台，站台，政纲	n. 
platinum	白金	n. 
play	玩，扮演，演奏	v. 
player	选手，演奏者	n. 
playground	运动场，操场	n. 
playmate	游伴	n. 
playwright	剧作家	n. 
plea	请求，恳求，辩解	n. 
plead	恳求，辩解	v. 
pleasant	令人愉快的	adj. 
please	使高兴，喜欢，请	v. 
pleased	高兴的，乐意的	adj. 
pleasure	快乐，乐事，乐趣	n. 
pledge	暂约，抵押	n. 
plenary	完全的	adj. 
plentiful	大量的，丰富的	adj. 
plenty	大量，丰富	n. 
plight	保证，困境	n. 
plot	阴谋，情节	n. 
plough	犁	n. v. 
pluck	拔，摘	v. 
plug	塞子，插头	n. 
plumb	测锤，垂直	v. 
plumber	管子工	n. 
plume	羽毛，羽饰	n. 
plump	丰满的	adj. 
plunder	掠夺，抢劫	v. n. 
plunge	插进，跳入	v. 
plural	复数的	adj. 
plus	加	prep. 
ply	出力，努力从事	v. 
pneumatic	气体的，空气的	adj. 
pneumonia	风湿病	n. 
pocket	衣袋	n. 
poem	诗歌	n. 
poet	诗人	n. 
poetry	诗，诗意，诗艺	n. 
point	尖，点，分	n. 
pointed	尖的	adj. 
poison	毒，毒药	n. 
poisonous	有毒的	adj. 
poke	戳，刺	v. 
poker	扑克	n. 
polar	极的	adj. 
polarity	极性，极端	n. 
pole	柱，杆，极	n. 
police	警察(局)	n. 
policeman	警察	n. 
policy	政策，方针，保险单	n. 
polish	擦亮，磨光，润色	v. 
polite	有礼貌的，客气的	adj. 
politeness	礼貌，客气	n. 
political	政治的	adj. 
politician	政治家，政客	n. 
politics	政治学，政治活动	n. 
poll	选举投票，民意测验	n. 
pollute	污染，弄脏	v. 
pollution	污染	n. 
polymer	聚合物	n. 
pond	池塘	n. 
ponder	考虑，沉思	v. 
pony	小马	n. 
pool	水塘，游泳池	n. 
poor	穷的，差的	adj. 
pop	砰的一声，爆裂	v. n. 
popcorn	爆米花	n. 
pope	教皇	n. 
popular	受欢迎的	adj. 
popularity	名望，知名	n. 
popularize	普及，宣传	v. 
population	人口	n. 
porcelain	瓷，瓷器	n. 
porch	门廊	n. 
pore	毛孔	n. 
pork	猪肉	n. 
porridge	粥，麦片粥	n. 
port	港口，港	n. 
portable	手提的，经便的	adj. 
porter	搬运工	n. 
portion	一份，部分	n. 
portrait	肖像，画像，描写	n. 
portray	描写，给...画像	v. 
portugal	葡萄牙	n. 
portuguese	葡萄牙人(的)	n. adj. 
pose	作姿态，提供考虑	v. 
position	位置，地位，处境	n. 
positive	明确的，肯定的	adj. 
positively	断言地，绝对地	adv. 
possess	占有，拥有，控制	v. 
possession	所有，财产	n. 
possessive	所有(格)的	adj. 
possibility	可能性	n. 
possible	可能的	adj. 
possibly	可能，或许	adv. 
post	柱，职位	n. 
postage	邮资	n. 
postal	邮政的	adj. 
postcard	明信片	n. 
posterity	子孙，后代	n. 
postman	邮递员	n. 
post-office	邮局	n. 
postpone	推迟，延迟	v. 
postponement	推迟	n. 
postulate	假定，主张	v. 
pot	罐，壶，锅	n. 
potato	马铃薯，土豆	n. 
potent	有效的	adj. 
potential	潜在的	adj. 
potentiality	潜在性	n. 
poultry	家禽	n. 
pound	英镑，磅	n. 
pour	注，灌，倒，涌出	v. 
poverty	贫穷，缺乏	n. 
powder	粉末	n. 
power	力，动力，权力	n. 
powerful	有力的，强的	adj. 
practicable	可行的	adj. 
practical	实用的，可行的	adj. 
practically	实际地，几乎	adj. 
practice	练习，习惯，实施	n. 
practise	练习，习惯于做	v. 
prairie	大草原	n. 
praise	赞美，称颂	v. n. 
pray	祈祷	v. 
prayer	祷告，祷文	v. 
preach	说教，鼓吹，布道	v. 
preacher	鼓吹者，宣教士	n. 
precaution	预防，防备	n. 
precede	在前，高于	v. 
precedence	领先，优先权	n. 
precedent	先例，惯例	n. 
preceding	前面的，上述的	adj. 
precious	宝贵的，珍爱的	adj. 
precise	精确的，严格的	adj. 
precisely	精确地	adv. 
precision	精确，精度	n. 
predecessor	前任，原有物	n. 
predict	预言	v. 
prediction	预言，预报	n. 
predominance	优越，杰出	n. 
predominant	主要的，有势力的	adj. 
preface	序言，开场白	n. 
prefer	较喜欢，宁愿	v. 
preferable	更喜爱的	adj. 
preferably	更好地	adv. 
preference	偏爱(之物)	n. 
preferential	优惠的	adj. 
prefix	前缀	n. 
pregnancy	怀孕	n. 
pregnant	怀孕的	adj. 
prejudice	偏见，成见	n. 
preliminary	初步的，预备的	adj. 
prelude	序言，前兆，序曲	n. 
premature	早熟的	adj. 
premier	首相，总理	n. 
premises	建筑物	n. 
premium	津贴	n. 
preoccupy	使迷住，专心于	v. 
preparation	准备，预备	n. 
prepare	准备，配制	v. 
prepared	准备好的，预制的	adj. 
preposition	介词	n. 
prescribe	命令，规定，开处方	v. 
prescribed	规定的	adj. 
prescription	药方	n. 
presence	出席，在场	n. 
present	在场的	adj. 
presentation	提出，演出	n. 
presently	不久，目前	adv. 
preservation	保藏，保存	n. 
preserve	保护，保藏，保持	v. 
preset	预先安排	v. 
preside	主持	v. 
president	总统，总经理，校长	n. 
presidential	总统的	adj. 
press	压，榨，按	v. 
pressing	急迫的	adj. 
pressure	压力，繁忙，紧迫	n. 
prestige	威望，声望	n. 
presumably	也许，大概	adv. 
presume	假定，推测	v. 
pretend	假装，佯称	v. 
pretense	借口	n. 
pretentious	自负的，虚伪的	adj. 
pretty	精致的，漂亮的	adj. 
prevail	获胜，流行	v. 
prevailing	占上风的	adj. 
prevalence	流行	n. 
prevalent	流行的，普遍的	adj. 
prevent	防止，阻碍	v. 
prevention	防止，预防	n. 
previous	早先的，先前的	adj. 
previously	预先，先前	adv. 
prey	猎物，牺牲品	n. 
price	价格，代价	n. 
price-list	价格表	n. 
pricing	定价	n. 
prick	刺穿	v. 
pride	骄傲，自豪，自负	n. 
priest	教士，神父	n. 
primarily	首要地，主要地	adv. 
primary	首要的，初级的	adj. 
prime	首要的，第一的	adj. 
primitive	原始的，简朴的	adj. 
prince	王子，诸侯	n. 
princess	公主，王妃	n. 
principal	重要的，主要的	adj. 
principally	主要地	adv. 
principle	原则，原理，主义	n. 
print	印刷，出版	v. 
printer	印刷者	n. 
prior	较早的，在前的	adj. 
priority	优先，居先	n. 
prism	棱镜	n. 
prison	监狱，牢房	n. 
prisoner	囚犯	n. 
privacy	私事，隐私	n. 
private	私人的，秘密的	adj. 
privilege	特权	n. 
privileged	有特权的	adj. 
prize	奖品，奖赏	n. 
probability	可能性，概率	n. 
probable	很可能的	adj. 
probably	或许，大概	adv. 
probe	细察，查究	v. 
problem	课题，难题，问题	n. 
problematic	有问题的	adj. 
procedure	手续，程序	n. 
proceed	前进，继续向前	v. 
proceeding	进行，诉讼	n. 
proceeds	收益	n. 
process	程序，过程	n. 
processing	加工(的)	n. adj. 
procession	行列，仪仗	n. 
proclaim	宣布，公布	v. 
procure	采购	v. 
procurement	采购	n. 
produce	生产，制造，创作	v. 
producer	生产者	n. 
product	产品，作品	n. 
production	生产，制造	n. 
productive	能生产的，多产的	adj. 
productivity	生产力，生产率	n. 
profess	表白	v. 
profession	职业，专业，表白	n. 
professional	专业人员	adj. 
professor	教授	n. 
proficiency	熟练，精通	n. 
proficient	熟练的，精通的	adj. 
profile	侧面，轮廓	n. 
profit	利润	n. 
profitable	有利可图的	adj. 
proforma	形式的	adj. 
profound	深奥的，深深的	adj. 
program	节目，规划，项目	n. 
programer	项目，程序制定者	n. 
programing	程序编排	n. 
progress	进步，进展	n. v. 
progressive	前进的，进步的	adj. 
prohibit	禁止，阻止	v. 
prohibition	禁止，禁令	n. 
prohibitive	禁止的	adj. 
project	计划	n. 
projection	射出，投射	n. 
projector	电影放映机	n. 
proletarian	无产阶级	adj. n. 
prolong	延长	v. 
prominence	显著，突出	n. 
prominent	著名的，显著的	adj. 
promise	允诺，预示	v. 
promising	有希望的	adj. 
promissory	约定的	adj. 
promote	提升，促进，宣传	v. 
promotion	晋级，提高，促销	n. 
prompt	及时的，迅速的	adj. 
promptly	及时地，敏捷地	adv. 
prone	俯伏的	adj. 
pronoun	代词	n. 
pronounce	发音，宣布	v. 
pronunciation	发音	n. 
proof	证明，证据，实验	n. 
propaganda	宣传	n. 
propagate	繁殖，传播，宣传	v. 
propagation	繁殖，传播	n. 
propel	推进，推动	v. 
propellent	推进的	adj. 
propeller	推进器，螺旋桨	n. 
proper	合适的，本来的	adj. 
properly	合适地	adv. 
property	财产，地产，特性	n. 
prophesy	预言	n. 
prophet	预言家	n. 
proportion	比例，部分	n. 
proportional	成比例的	adj. 
proposal	建议，计划	n. 
propose	建议，打算，求婚	v. 
proposition	建议，提议	n. 
proprietor	所有者，业主	n. 
proprietorship	业主资格	n. 
prose	散文	n. 
prosecute	迫害	v. 
prosecution	迫害	n. 
prosecutor	检查官	n. 
prospect	前景	n. 
prosperity	繁荣，兴旺	n. 
prosperous	繁荣的，兴旺的	adj. 
protect	保护，警戒	v. 
protection	保护，警戒	n. 
protectionism	贸易保护主义	n. 
protective	保护的	adj. 
protein	蛋白质	n. 
protest	抗议，反对	v. n. 
protestant	清教徒，新教徒	n. 
protocol	协议，议定书	n. 
prototype	原型	n. 
protracted	延长了的	adj. 
proud	骄傲的，得意的	adj. 
prove	证明，表明是	v. 
proverb	谚语，格言	n. 
provide	供给，提供，准备	v. 
provided	只要	conj. 
province	省份，领域	n. 
provincial	省级的，省的	adj. 
provision	准备，条款，辎重	n. 
provisional	临时的	adj. 
provocation	刺激，煸动	n. 
provoke	激怒，引起	v. 
proximo	下月的	adj. 
prudence	谨慎	n. 
prudent	谨慎的	adj. 
psychological	心理(上)的	adj. 
psychologist	心理学家	n. 
psychology	心理学，心理状态	n. 
public	公众的，公共的	adj. 
publication	出版物，发表	n. 
publicity	公开	n. 
publicly	公开地	adv. 
publish	出版，发表，公布	v. 
publisher	出版商	n. 
pudding	布丁	n. 
puff	一阵	n. 
pull	拖，拔	v. 
pull	拖，拔，	v. 
pulley	滑轮	n. 
pulse	脉搏	n. 
pump	泵	n. 
pumpkin	南瓜	n. 
punch	用拳击，冲孔	n. v. 
punctual	准时的，守时的	adj. 
punctuality	准时	n. 
punctuation	准时	n. 
punish	处罚，惩罚	v. 
punishment	处罚，刑罚	n. 
pupil	小学生，瞳孔	n. 
puppet	木偶，傀儡	n. 
puppy	小狗	n. 
purchase	购买	v. n. 
purchaser	买主	n. 
pure	纯洁的，纯净的	adj. 
purely	全然，纯然	adv. 
purify	净化	v. 
purity	纯粹，纯净	n. 
purple	紫色	n. 
purpose	目的，用途，意图	n. 
purse	钱包	n. 
pursuance	追求，实行	n. 
pursuant	追逐者	n. 
pursue	追逐，从事，追求	v. 
pursuit	追逐，追求，职业	n. 
push	推，推动	v. 
put	放置，估价，表达	v. 
puzzle	使困惑	v. 
pyjamas	睡衣	n. 
pyramid	金字塔	n. 
qualification	资格，条件	n. 
qualified	有资格的	adj. 
qualify	使合格，使胜任	v. 
qualitative	质量的，定性的	adj. 
quality	特性，属性，质量	n. 
quantitative	数量的，定量的	adj. 
quantity	量，大量	n. 
quarrel	争吵	v. n. 
quart	夸脱(容量单位)	n. 
quarter	四分之一，一刻钟	n. 
quarterly	季度的	adj. 
quartz	石英	n. 
quay	码头	n. 
queen	王后，女王	n. 
queer	奇妙的，古怪的	adj. 
quench	抑制，熄灭，淬火	v. 
query	询问	v. n. 
quest	寻找，搜索	n. 
question	问题，疑问	n. 
questionnaire	调查表	n. 
queue	辫子，队	n. 
quick	快的，灵敏的	adj. 
quicken	加快，加速，刺激	v. 
quickly	快，迅速地	adv. 
quiet	安静的，轻声的	adj. 
quietly	安静地，静静地	adv. 
quietness	平静，安定，安静	n. 
quilt	被子	n. 
quit	停止，放弃，退出	v. 
quite	完全，十分，相当	adv. 
quiver	颤抖	v. 
quiz	测验，问答比赛	n. 
quota	定额，配额	n. 
quotation	引语，语录，报价单	n. 
quote	引用，引证，报价	v. 
rabbit	兔子	n. 
race	种族，竞赛	n. 
racial	种族的，人种的	adj. 
rack	搁班，行李架	n. 
racket	喧闹，球拍	n. 
radar	雷达	n. 
radial	放射的，辐射的	adj. 
radiant	发光的	adj. 
radiate	辐射，放射，发光	v. 
radiation	辐射，发射	n. 
radical	基本的，激进的	adj. 
radio	无线电，收音机	n. 
radioactive	放射性的	adj. 
radioactivity	放射性	n. 
radish	萝卜	n. 
radium	镭	n. 
radius	半径，活动范围	n. 
rag	抹布，破衣服	n. 
rage	盛怒，流行	n. 
raid	袭击，搜查	v. 
rail	栏杆，钢轨	n. 
railroad	铁路	n. 
railway	铁路，铁路公司	n. 
rain	雨	n. 
rainbow	虹	n. 
raincoat	雨衣	n. 
rainfall	下雨，降雨量	n. 
rainy	有雨的	adj. 
raise	举起，提高，唤起	v. 
rake	耙	n. v. 
rally	集会	n. v. 
ramble	漫步	n. 
ranch	牧场	n. 
random	胡乱的，随便的	adj. 
range	射程，范围，一系列	n. 
rank	军衔，等级	n. 
rapid	快的，急速的	adj. 
rapidly	迅速地，急速地	adv. 
rapture	狂喜	n. 
rare	稀有的，罕见的	adj. 
rarely	难得，少有	adv. 
rascal	无赖，恶棍	n. 
rash	轻率的，鲁莽的	adj. 
rat	老鼠，耗子	n. 
rate	比率，速度，费率	n. 
rather	相当，颇，宁愿	adv. 
ratification	批准，认可	n. 
ratify	批准，认可，追认	v. 
ratio	比，比率	n. 
ration	理性	n. 
rational	合理的，有理性的	adj. 
rattle	嘎吱响	v. n. 
ravage	破坏，暴力	n. 
raw	生的，未加工的	adj. 
ray	光线，射线，辐射	n. 
razor	剃须刀	n. 
re	关于	prep. 
reach	到达，伸手，够到	v. 
react	反应，起反应，反抗	v. 
reaction	反应，反动	n. 
reactionary	反动的	adj. 
reactor	反应堆	n. 
read	读，阅读，朗诵	v. 
reader	读者，读本	n. 
readily	容易地，乐意地	adv. 
reading	读书，读数，读本	n. 
ready	准备好的，乐意的	adj. 
real	真的，纯粹的	adj. 
realism	现实主义，写实主义	n. 
realist	现实主义者(的)	n. 
realistic	现实的，实在的	adj. 
reality	现实，真实性	n. 
realization	实现	n. 
realize	认识到，实现，执行	v. 
really	真正地，果然	adv. 
realm	王国，领域	n. 
reap	收割，收获	v. 
rear	后部	n. 
reason	原因，理由	n. 
reasonable	有理的，讲理的	adj. 
reasonably	合理地，适当地	adv. 
reassure	使...放心	v. 
rebate	回扣，折扣	n. 
rebel	起义，反叛	v. 
rebellion	叛乱，起义	n. 
rebuke	斥责	v. 
recall	想到，召回，取消	v. 
recede	归还，撤回	v. 
receipt	收到，收据	n. 
receive	收到，接待，扯	v. 
receive	收到，接待，	v. 
receiver	受领人，听筒	n. 
recent	近来的，新近的	adj. 
recently	近来，最近	adv. 
reception	招待会，欢迎会	n. 
receptionist	接待员	n. 
recession	衰退	n. 
recipe	菜谱，配方	n. 
recipient	接受者	n. 
reciprocal	相互的，互易的	adj. 
recitation	朗诵	n. 
recite	背诵，朗诵，讲述	v. 
reckless	鲁莽的	adj. 
reckon	数，计算，认为	v. 
reclaim	收回，开垦	v. 
recognition	认出，承认	n. 
recognize	认出，识别，承认	v. 
recollect	回忆，追想	v. 
recollection	回忆	n. 
recommend	推荐，介绍，劝告	v. 
recommendation	推荐(书)	n. 
recompense	回报，赔偿	v. n. 
reconcile	使和好，调停	v. 
reconnaissance	探索，勘查	n. 
record	记录，录音	v. 
recorder	记录员，录音机	n. 
recourse	求助	n. 
recover	寻回，恢复，复原	v. 
recovery	寻回，恢复	n. 
recreation	消遣，文娱活动	n. 
recruit	招募，征兵	v. 
recruitment	招募	n. 
rectangle	长方形，矩形	n. 
rectification	纠正	n. 
rectify	纠正，订正	v. 
recur	再发生，复发	v. 
recurrence	再发生	n. 
red	红的	adj. 
redeem	买回，赎回	v. 
rediculous	可笑的，荒谬的	adj. 
redound	增加，促进	v. 
reduce	减少，贬为	v. 
reduction	减少，缩减	n. 
reed	芦苇，芦笛	n. 
reef	礁石	n. 
reel	卷，线轴	n. 
reexport	再出口	v. 
refer	查阅，提及	v. 
referee	裁判员	n. 
reference	参考(书)，推荐书	n. 
referent	被谈到的事	n. 
refine	精炼，精制	v. 
refined	精炼的，精的	adj. 
refinement	精炼	n. 
refinery	精炼厂	n. 
reflect	反射，反映，反省	v. 
reflection	反射，映象，反思	n. 
reform	改革，改造	v. n. 
refrain	抑制	v. 
refresh	使清醒，使振作	v. 
refreshment	茶点，饮料	n. 
refrigerator	冰箱	n. 
refuge	藏身处，避难所	n. 
refugee	难民	n. 
refund	再投资,归还	v. 
refusal	拒绝，谢绝	n. 
refuse	拒绝	v. 
refute	驳斥，反驳	v. 
regard	认为，尊重，关于	v. 
regarding	关于	prep. 
regardless	不顾的(地)	adj. adv. 
regime	政体，制度	n. 
regiment	团，大量	n. 
region	地区，地域，地带	n. 
regional	地区的，区域的	adj. 
regionalization	区域化	n. 
regionalize	使区域化	v. 
register	登记，注册，挂号	v. 
registered	登记的，注册的	adj. 
registration	登记	n. 
regret	懊悔	v. 
regretful	遗憾的	adj. 
regretfully	遗憾地	adv. 
regrettable	可遗憾的	adj. 
regular	正常的，有规律的	adj. 
regularity	整齐，规律	n. 
regularly	整齐地，有规律地	adv. 
regulate	管理，调整	v. 
regulation	管理，规则，法令	n. 
rehearsal	排练，彩排	n. 
rehearse	排练	v. 
reign	统治	n. 
reimburse	偿还	v. 
reimbursement	偿还，还款	n. 
rein	缰绳	n. 
reinforce	增援，加强	v. 
reinforcement	加强，援兵	n. 
reiterate	重申	v. 
reject	拒绝	v. 
rejection	拒绝	n. 
rejoice	欢欣，使喜悦	v. 
relate	叙述，关联，涉及	v. 
related	与...有关的	adj. 
relation	关系，得害关系	n. 
relationship	关系，联系	n. 
relative	亲戚	n. 
relatively	比较地，相对地	adv. 
relativity	相关性，相对论	n. 
relax	松弛，舒张，休息	v. 
relaxation	放松，松弛	n. 
relay	转播，中继	v. 
release	释放，透露，发行	v. 
relevant	相关的	adj. 
reliability	可靠性	n. 
reliable	可靠的，可依赖的	adj. 
reliance	依靠，信赖	n. 
relief	解除，减轻，安慰	n. 
relieve	解除，减轻，换班	v. 
religion	宗教(信仰)	n. 
religious	宗教的，信教的	adj. 
relinquish	放弃	v. 
relish	味道，风味	n. 
reluctance	不愿，勉强	n. 
reluctant	不愿的，勉强的	adj. 
rely	依靠，依赖	v. 
remain	依旧的，剩余，逗留	n. 
remainder	剩余部分	n. 
remains	剩余，遗迹，遗体	n. 
remark	说起，留意，评论	v. 
remarkable	显著的，异常的	adj. 
remedy	药品，治疗(方法)	n. 
remember	记得，想起，记住	v. 
remembrance	记得，记忆	n. 
remind	提醒，使想起	v. 
reminiscence	回想，回忆，怀念	n. 
reminiscent	使想起...的	adj. 
remit	汇款，汇出	v. 
remittance	汇款	n. 
remnant	残余，残迹	n. 
remote	遥远的，疏远的	adj. 
remoteness	遥远，疏远	n. 
removal	移开，除去，移居	n. 
remove	移开，除去，罢免	v. 
remuneration	列举	n. 
renaissance	(文艺)复兴	n. 
render	使得，给予，翻译	v. 
renew	更新，续期	v. 
renewable	可续期的	adj. 
renewal	更新，续订	n. 
rent	租金	n. 
rental	租借的，租金的	adj. 
repair	修理，纠正	v. 
repairmen	修理，修补，纠正	n. 
repay	偿付，报答	v. 
repeal	撤消，废除	v. n. 
repeat	重复，背诵	v. 
repeatedly	重复地，一再地	adj. 
repel	驱逐，推开	v. 
repent	后悔，悔悟	v. 
repetition	重复，反复，复制	n. 
repetitive	重复的，反复的	adj. 
replace	归还原处，代替	v. 
replacement	归回，代替(物)	n. 
replenish	补充	v. 
replenishment	补充(货物)	n. 
reply	回答，答复	v. n. 
report	报告，报导，报道	v. 
reportage	报告文学	n. 
reporter	报告人，记者	n. 
represent	表示，表现，代表	v. 
representation	表示，代表	n. 
representative	代表	adj. 
reproach	责备，指责	v. n. 
reproduce	复制，再造，繁殖	v. 
reproduction	复制(器)	n. 
reptile	爬行动物	n. 
republic	共和国	n. 
republican	共和(派)的	n. adj. 
repudiate	拒绝接收，拒付	n. 
reputable	声誉好的	adj. 
reputation	名声，声誉	n. 
repute	声誉	n. 
request	请求	n. 
require	需要，请求	v. 
requirement	要求，需要	n. 
requisite	必要的，需要的	adj. 
rescind	退还，取消	adj. 
rescue	救援，救出	v. n. 
research	调查，研究	v. n. 
researcher	调查者，研究人员	n. 
resemblance	相仿，类似	n. 
resemble	象，类似	v. 
resent	不满于，愤恨	v. 
resentful	不满的，怨恨的	adj. 
resentment	不满，愤恨	n. 
reservation	贮存物，预定	n. 
reserve	贮备，保存，预定	v. 
reservoir	水库	n. 
reside	居住，存在	v. 
residence	住宅，住处	n. 
resident	居民	n. 
residual	剩余的	adj. 
resign	辞职	v. 
resignation	辞职	n. 
resist	抵抗，忍住	v. 
resistance	抵抗，阻力，反感	n. 
resistant	抵抗的，反对的	n. 
resolute	坚决的，果断的	adj. 
resolutely	坚决地，果断地	adj. 
resolution	决议，决定，决心	n. 
resolve	决定，解决，分解	v. 
resort	诉诸，求助	v. 
resource	资源，机智，策略	n. 
respect	尊重，重视，尊敬	v. 
respectable	可敬的	adj. 
respectful	恭敬的，尊重的	adj. 
respectfully	恭敬地	adv. 
respective	各自的，各个的	adj. 
respectively	各自，分别地	adv. 
respond	答复，反应，响应	v. 
response	答复，反应，响应	v. 
responsibility	责任，职责	n. 
responsible	负责的，尽责的	adj. 
rest	休息	v. 
restaurant	饭馆，餐厅	n. 
restless	没休息的，不安的	adj. 
restock	重新进货	v. 
restore	恢复，复原，归还	v. 
restrain	抑制，制止	v. 
restraint	抑制，自制	n. 
restrict	限制，约束	v. 
restriction	限制，约束	n. 
restrictive	限制的	n. 
result	结果，效果，后果	n. 
resultant	结果的，合成的	adj. 
resume	个人简历，摘要	n. 
resume	继续，再度	v. 
retail	零售	v. n. 
retailer	零售商	n. 
retain	保留，记忆，雇	v. 
retell	复述	v. 
retire	退休，退隐，就寝	v. 
retirement	退休，隐居	n. 
retort	反驳，回嘴	v. 
retreat	退却，撤退	v. n. 
retroactive	可追溯的	adj. 
return	回归，归还	v. 
reveal	揭露，透露，显示	v. 
revenge	报仇，报复	n. v. 
revenue	岁入，收入	n. 
reverence	尊敬，崇敬	n. 
reverse	颠倒的，相反的	adj. 
revert	回复到，重议	v. 
review	检查，复习	v. n. 
revise	修改，校订，复习	v. 
revision	修改，修订	n. 
revival	复苏，再生	n. 
revive	苏醒，复苏	v. 
revoke	废除，取消，撤回	v. 
revolt	起义，反抗	n. v. 
revolution	革命，变革	n. 
revolutionary	革命的	adj. 
revolve	旋转，绕行	v. 
reward	报酬，酬金，报答	n. 
rewarding	有收获的	adj. 
rheumatism	风湿病	n. 
rhyme	韵，脚韵	n. 
rhythm	韵律，节奏	n. 
rib	肋，肋骨	n. 
ribbon	带子，缎带	n. 
rice	稻子，大米，米饭	n. 
rich	富的，富饶的	adj. 
richness	富饶，富有	n. 
rid	使摆脱，使除去	v. 
riddle	谜语，谜	n. 
ride	乘坐，骑	v. 
ridge	山脉，岭，屋脊	n. 
ridicule	嘲笑，挖苦	n. v. 
rifle	步枪，来福枪	n. 
right	正确的，右的	adj. 
righteous	正直的，公正的	adj. 
rigid	僵硬的，严厉的	adj. 
rigidity	僵硬，严厉，死板	adj. 
rigor	严格，严肃	n. 
rigorous	严厉的，酷热的	adj. 
rim	边缘，眼镜架	n. 
ring	鸣，打铃，打电话	v. 
rinse	漂洗，润丝	v. 
riot	骚乱，闹事	n. v. 
riotous	骚乱的，喧扰的	adj. 
rip	撕破，扯碎	v. 
ripe	熟的，成熟的	adj. 
ripen	成熟，变热	v. 
ripple	波纹，涟漪	n. 
rise	起立，晋级，增长	v. 
risk	冒险，风险	n. v. 
risky	有风险的，冒险的	adj. 
rival	对手	n. 
rivalry	竞争，对抗	n. 
river	河，江	n. 
road	道路，路	n. 
roam	漫步，漫游	v. 
roar	吼，怒号，轰鸣	v. n. 
roast	烤，炙	v. 
rob	抢劫，偷	v. 
robber	强盗	n. 
robbery	抢劫(案)	n. 
robe	长袍	n. 
robot	机器人	n. 
robust	强壮的，粗壮的	adj. 
rock	岩石	n. 
rocket	火箭	n. 
rod	小棒，竿	n. 
role	角色，作用	n. 
roll	滚，卷，转动，压平	v. 
roller	滚筒，压路机	n. 
roman	古罗马的	adj. 
romance	浪漫文学，浪漫故事	n. 
romantic	浪漫的，好幻想的	adj. 
romanticism	浪漫主义	n. 
rome	罗马	n. 
roof	屋顶	n. 
room	房间，室，空间	n. 
rooster	公鸡	n. 
root	根，根源	n. 
rope	绳，索	n. 
rose	玫瑰，蔷薇	n. 
rosy	玫瑰红的，幻想的	adj. 
rot	腐烂，枯朽	v. 
rotary	旋转的	adj. 
rotate	旋转，循环，转流	v. 
rotation	旋转，更替	n. 
rotten	腐烂的，发臭的	adj. 
rough	粗糙的，粗野的	adj. 
roughly	大约地，粗略地	adv. 
round	在周围	adj. 
roundabout	迂回的，转弯抹角	adj. 
rouse	唤醒，惊起	v. 
route	路线，航线	n. 
routine	日常事务	n. 
row	划船	v. 
royal	王室的，皇家的	adj. 
royalty	皇家，皇族	n. 
rub	擦，摩擦，涂抹	v. 
rubber	橡胶，橡皮	n. 
rubbish	垃圾，废物，废话	n. 
rude	粗鲁的，下流的	adj. 
rug	小块地毯	n. 
ruin	废墟	n. 
ruinous	毁灭性的	adj. 
rule	法规，常规，统治	n. 
ruler	统治者，直尺	n. 
ruling	统治的	adj. 
rumor	传闻，谣言	n. v. 
run	跑，竞选，行驶	v. 
runner	奔跑者，赛跑运动员	n. 
running	连续的	adj. 
rural	农村的	adj. 
rush	冲，冲进	v. n. 
russia	俄罗斯，俄语	n. 
russian	俄国(人)的	n. adj. 
rust	锈	n. 
rusty	生锈的	adj. 
ruthless	无情的，冷酷的	adj. 
sack	麻袋	n. 
sacred	神圣的	adj. 
sacrifice	牺牲(品)	n. v. 
sad	悲哀的，可悲的	adj. 
saddle	马鞍	n. 
sadly	悲哀地，可惜	adv. 
sadness	悲哀	n. 
safe	安全的，无风险的	adj. 
safely	安全地，平安地	adv. 
safety	安全	n. 
sag	下跌	v. 
said	上述的，该	adj. 
sail	帆	n. 
sailing	启航的	adj. 
sailor	水手，海员	n. 
saint	圣人，圣徒	n. 
sake	缘故，利益	n. 
salability	适销性	n. 
salable	有销路的，适销的	adj. 
salad	色拉，拌凉菜	n. 
salary	工资，薪水	n. 
sale	出售，贱卖	n. 
sales	销售	n. 
salesman	售货员，推销员	n. 
salmon	鲑，大马哈鱼	n. 
salt	盐	n. 
salty	咸的	adj. 
salute	行礼，致敬	v. 
salution	致敬	n. 
same	同样的	adj. 
sample	样品	n. 
sampling	抽样	n. 
sand	沙子	n. 
sandwich	三明治	n. 
sandy	沙的，沙色的	adj. 
sanitary	疗养院	n. 
sarcasm	讽刺，挖苦	n. 
sarcastic	讽刺的	adj. 
sardine	沙丁鱼	n. 
satellite	卫星	n. 
satire	讽刺作品	n. 
satisfaction	满足，满意	n. 
satisfactorily	圆满地	adv. 
satisfactory	令人满意的	adj. 
satisfy	满足，使满意，偿还	v. 
saturation	浸透，饱和	n. 
saturday	星期六	n. 
saturn	土星	n. 
sauce	调味汁，酱油	n. 
saucer	茶碟	n. 
sausage	香肠，腊肠	n. 
savage	野蛮的，残暴的	adj. 
save	救，拯救，储蓄	v. 
savings	存款，储蓄额	n. 
saw	锯	v. n. 
say	说	v. 
scale	刻度，等级，秤	n. 
scaly	鱼鳞状的	adj. 
scan	浏览，细察，扫描	v. 
scandal	丑闻	n. 
scar	疤，疤痕	n. 
scarce	缺乏的，罕见的	adj. 
scarcely	几乎没有，将近	adv. 
scarcity	缺乏，不足	n. 
scare	惊吓	v. 
scarf	围巾，头巾	n. 
scarlet	猩红的，鲜红的	adj. 
scatter	散布，撒播	v. 
scene	现场，情景，一场戏	n. 
scenery	风景，布景	n. 
scenic	风景如画的	adj. 
scent	气味，香味	n. 
schedule	时间表	n. 
scheme	计划，方案，图谋	n. 
scholar	学者	n. 
scholarship	奖学金，学问	n. 
school	学校，上学，学系	n. 
schooling	学校教育	n. 
science	科学，学科	n. 
scientific	科学的	adj. 
scientist	科学家	n. 
scissors	剪刀	n. 
scoff	嘲笑，嘲弄	v. 
scold	训斥，责骂	v. n. 
scope	范围	n. 
scorch	烧焦	v. 
scorching	灼热的	adj. 
score	得分，成绩，二十	n. 
scorn	蔑视，不屑	n. v. 
scornful	蔑视的，轻视的	adj. 
scotch	苏格兰	n. 
scotland	苏格兰	n. 
scotsman	苏格兰人	n. 
scottish	苏格兰的	adj. 
scout	侦察员，童子军	n. 
scramble	爬，攀，争夺	v. 
scrap	碎片，废品，屑	n. 
scrape	擦，刮，凑集	v. 
scratch	抓破，挠	v. 
scream	尖叫声	v. n. 
screech	尖叫(声)	v. n. 
screen	屏，帘	n. 
screw	拧	v. 
screwdriver	螺丝刀，改锥	n. 
script	临时单据	n. 
scrub	擦洗，刷	v. 
scrutiny	细看，复查	n. 
sculptor	雕塑家	n. 
sculpture	雕塑，雕刻	n. 
sea	海，海洋	n. 
seal	封	v. 
seam	接缝	n. 
seaman	海员，水手	n. 
seaport	海港，港口	n. 
search	搜查，寻找	v. n. 
seashore	海滨	n. 
seaside	海边	n. 
season	季节	n. 
seasonal	季节性的	adj. 
seat	座位，席位	n. 
secondary	第二的，次要的	adj. 
secondhand	二手的，间接的	adj. 
secondly	第二，其次	adv. 
secrecy	秘密(状态)	n. 
secret	秘密的	adj. 
secretariat	秘书处	n. 
secretary	秘书，部长，书记	n. 
section	部分，区域	n. 
sector	部分，部门	n. 
secure	安全的，可靠的	adj. 
security	安全，有价证券	n. 
see	看见，明白，查看	v. 
seed	种子	n. 
seek	寻觅，企图获得	v. 
seem	好象，似乎	v. 
seemingly	表面上	adv. 
segment	部分，节，片	n. 
seize	抓住，夺取，占领	v. 
seizure	强占，没收	n. 
seldom	难得，不常	adv. 
select	挑选	v. 
selection	选择，选集	n. 
self	自己，自身，品质	n. 
selfish	自私的，利己的	adj. 
sell	卖，出售	v. 
seller	卖方	n. 
semiconductor	半导体	n. 
seminar	研讨会，学术讲座	n. 
senate	参议院	n. 
senator	参议员	n. 
send	派遣，送，寄出，请	v. 
sender	寄信人	n. 
senior	年长的，老资格的	adj. 
sensation	感觉，感动	n. 
sensational	轰动的	adj. 
sense	感官，感觉，见识	n. 
senseless	无意义的	adj. 
sensible	明智的，感知的	adj. 
sensitive	敏感的	adj. 
sensitivity	灵敏度	n. 
sentence	句子	n. 
sentiment	感情，情绪	n. 
sentimental	多愁善感的	adj. 
separate	分离，分隔，分手	v. 
separately	分别地	adv. 
separation	分离，分开	n. 
september	九月	n. 
sequence	一连串，顺序	n. 
serene	清澈的，晴朗的	adj. 
serenity	晴朗	n. 
series	系列，从书	n. 
serious	慎重的，严重的	adj. 
seriously	严肃地，严重地	adv. 
sermon	布道，说教	n. 
serpent	大蛇	n. 
servant	仆人	n. 
serve	服务，任职，服役	v. 
service	服务，公共设施	n. 
serviceable	有用的，耐用的	adj. 
session	会议，会期，市，盘	n. 
set	放，指定	v. 
setting	安置，背景，环境	n. 
settle	解决，安置，支付	v. 
settlement	解决，结算	n. 
seven	七	num. 
seventeen	十七	num. 
seventh	第七，七分之一	num. 
seventy	七十	num. 
several	几个	adj. 
severe	严厉的，苛刻的	adj. 
severely	严厉地，苛刻地	adv. 
sew	缝纫	v. 
sewing-machine	缝纫机	n. 
sex	性，性别	n. 
sexual	性的，性感的	adj. 
sexuality	性欲	n. 
shabby	褴褛的，不体面的	adj. 
shade	阴影，遮光物，浓淡	n. 
shadow	影子，阴影	n. 
shadowy	有阴影的，模糊的	adj. 
shady	遮阴的，背阴的	adj. 
shaft	柄，竖井	n. 
shake	摇动，发抖，握手	v. 
shall	将	v. 
shallow	浅的，浅薄的	adj. 
sham	赝品	n. 
shame	羞耻，耻辱	n. 
shameful	可耻的，丢脸的	adj. 
shampoo	洗发香波	n. 
shape	形状，轮廓	n. 
shapeless	不定形的	adj. 
share	份，股份	n. 
shark	鲨鱼	n. 
sharp	锐利的，明显的	adj. 
sharpen	削尖，磨快	v. 
sharpener	铅笔刀，磨石	n. 
sharply	尖锐地，敏锐地	adv. 
shatter	粉碎，毁坏	v. 
shave	剃，修脸	v. 
she	她	pron. 
shear	剪毛，切割	v. 
shed	流下	v. 
sheep	绵羊	n. 
sheepish	胆怯的	adj. 
sheer	全然的，极薄的	adj. 
sheet	被单，张，大片	n. 
shelf	架子，搁板	n. 
shell	壳，英，炮弹，外壳	n. 
shelter	躲避处，庇护	n. 
shepherd	牧羊人	n. 
sheriff	郡长，警官	n. 
shield	盾牌	n. 
shift	转变	v. 
shilling	先令	n. 
shine	发光，照射，照耀	v. 
shiny	耀眼的	adj. 
ship	船，舰	n. 
shipbuilding	造船业	n. 
shipmail	随船带交	n. 
shipment	船运，一船货	n. 
shipowner	船主	n. 
shipping	船运，装运	n. 
shipwreck	(船只)失事	n. 
shipyard	船坞	n. 
shirt	衬衣	n. 
shiver	发抖	v. 
shock	震惊，电击	n. 
shoe	鞋	n. 
shoemaker	鞋匠	n. 
shoot	射击，发芽	v. 
shop	商店，车间	n. 
shopkeeper	店主	n. 
shopping	购物	n. 
shore	岸，滨	n. 
short	短的，矮的	adj. 
shortage	缺少，不足	n. 
shortcoming	短处，缺点	n. 
shortcut	捷径	n. 
shorten	缩短	v. 
shorthand	速记	n. 
shortly	立刻，不久	adv. 
shorts	短裤	n. 
short-weight	短装，短重	n. 
shot	射击，弹丸	n. 
should	应该，会	v. 
shoulder	肩膀	n. 
shout	叫喊	v. n. 
shove	推，推开	v. 
shovel	铲子	n. 
show	显示，表明	v. 
shower	阵雨，淋浴	n. 
showroom	展室，陈列室	n. 
shrewd	机敏的，精明的	adj. 
shriek	尖叫(声)	v. n. 
shrill	刺耳的	v. 
shrimp	虾	n. 
shrine	神龛	n. 
shrink	收缩，畏缩	v. 
shroud	遮蔽物	n. 
shrub	灌木	n. 
shrug	耸肩	v. n. 
shuffle	拖脚走	v. 
shun	躲避，躲开	v. 
shut	关闭，合拢	v. 
shutter	百叶窗，快门	n. 
shuttle	梭	n. 
shy	害羞的，腼腆的	adj. 
sick	有病的，厌恶的	adj. 
sickle	镰刀	n. 
sickness	病	n. 
side	边，面，侧面，一方	n. 
sidewalk	人行道	n. 
sideways	侧面地	adv. 
siege	包围，围攻	v. 
sieve	筛子	n. 
sift	筛，细查	v. 
sigh	叹息，叹气	v. n. 
sight	视力，情景	n. 
sightseeing	观光，游览	n. 
sign	告示，迹象，符号	n. 
signal	信号	n. 
signal	信号	n. 
signature	签字	n. 
significance	重要性，意义	n. 
significant	重要的，有意义的	adj. 
signify	表示，意味	v. 
signpost	路标，广告柱	n. 
silence	寂静，沉默	n. 
silent	寂静的，沉默的	adj. 
silicon	硅	n. 
silk	丝，绸	n. 
silky	丝绸般的	adj. 
silly	糊涂的，愚蠢的	adj. 
silver	银，银餐具	n. 
similar	类似的，相象的	adj. 
similarity	类似，相似	n. 
simple	简单的，朴素的	adj. 
simplicity	简单，简朴，单纯	n. 
simplify	简单化	v. 
simply	简单地，仅	adv. 
simulate	假装，佯伪	v. 
simultaneous	同时(发生)的	adj. 
simultaneously	同时地	adv. 
sin	罪，罪恶	n. 
since	自从	prep. 
sincere	真诚的，诚挚的	adj. 
sincerely	真诚地	adv. 
sincerity	真诚，诚挚	n. 
sinful	有罪的，罪恶的	adj. 
sing	唱	v. 
singer	歌手	n. 
single	单个的，单身的	adj. 
singular	非凡的，单数的	adj. 
sink	沉，下落	v. 
sir	先生	n. 
siren	汽笛，报警器	n. 
sister	姊，妹	n. 
sit	坐，栖息	v. 
site	场所，场地	n. 
sitting-room	起居室	n. 
situate	位于，坐落在	v. 
situation	形势，局面	n. 
six	六	num. 
sixteen	十六	num. 
sixth	第六，六分之一	num. 
sixty	六十	num. 
sizable	相当大的	adj. 
size	大小，规模，尺寸	n. 
skate	冰鞋	n. 
skating	滑冰，溜冰	n. 
skeleton	骨架	n. 
sketch	素描，速写，草图	n. 
ski	雪撬	n. 
skiing	滑雪	n. 
skill	技能，技艺	n. 
skillful	熟练的	adj. 
skim	撇去，掠过，略谈	v. 
skin	皮，皮肤	n. 
skip	跳过，遗漏	v. 
skirmish	小冲突	n. 
skirt	裙子	n. 
skull	颅骨	n. 
sky	天，天空	n. 
skyrocket	猛涨	v. 
skyscraper	摩天大楼	n. 
slack	松驰的，不景气的	adj. 
slam	砰地关上	v. 
slander	诽谤，污蔑	n. v. 
slang	俚语	n. 
slap	掌击，掴	v. 
slaughter	屠宰，屠杀	v. n. 
slave	奴隶	n. 
slavery	奴隶制，奴役	n. 
slay	屠杀	v. 
sleep	睡眠	v. n. 
sleepy	欲睡的	adj. 
sleet	雨加雪	n. 
sleeve	袖子	n. 
slender	细长的，苗条的	adj. 
slice	薄片	n. 
slide	滑，溜	v. 
slight	轻微的，纤瘦的	adj. 
slightly	轻微地，稍稍	adv. 
slim	苗条的	adj. 
slip	滑，滑行，溜走	v. 
slipper	便鞋，拖鞋	n. 
slippery	滑的	adj. 
slit	割裂	v. 
slogan	标语，口号	n. 
slope	倾斜	v. 
slow	慢的，迟钝的	adj. 
slowdown	放慢，迟缓	n. 
slowly	慢慢地	adj. 
slum	贫民窟	n. 
slumber	睡眠，微睡	n. 
slump	暴跌，不景气	n. 
sly	狡猾的	adj. 
smack	滋味	n. 
small	小的，不重要的	adj. 
smart	聪明的，漂亮的	adj. 
smash	打破，粉碎，猛撞	v. 
smell	嗅,发出气味	v. 
smile	微笑	v. n. 
smog	烟雾	n. 
smoke	冒烟，抽烟	v. 
smoker	抽烟者	n. 
smoking	抽烟	n. 
smooth	平稳的，光滑的	adj. 
smoothly	顺利地，安稳地	adv. 
smuggle	走私，夹带	v. 
smuggler	走私者	n. 
smuggling	走私	n. 
snack	快餐，小吃	n. 
snail	蜗牛	n. 
snake	蛇	n. 
snap	折断(声)	v. n. 
snatch	抢夺，攫取	v. n. 
sneak	偷偷地逃走、做	v. 
sneakers	旅游鞋	n. 
sneer	嘲笑，讥笑	v. n. 
sneeze	打喷嚏	v. 
sniff	嗅，闻	v. 
snob	势利小人	n. 
snobbery	势利	n. 
snobbish	势利的	adj. 
snore	打鼾	v. 
snow	雪	n. 
snowman	雪人	n. 
snowstorm	暴风雪	n. 
snowy	有雪的，下雪的	adj. 
so	这样，也一样	adv. 
soak	浸，吸水，湿透	v. 
soap	肥皂	n. 
soar	急速上升，暴涨	v. 
sob	呜咽，啜泣	v. n. 
sober	清醒的，冷静的	adj. 
so-called	所谓的	adj. 
soccer	足球	n. 
sociable	善交际的，社交的	adj. 
social	社会的，社会性的	adj. 
socialism	社会主义	n. 
socialist	社会主义者、的	n. 
society	社会，协会，社交界	n. 
sociologist	社会学家	n. 
sociology	社会学	n. 
sock	短袜	n. 
soda	苏打，碱，苏打水	n. 
sodium	钠	n. 
sofa	沙发，软椅	n. 
soft	柔软的，温和的	adj. 
soften	使柔软，变软	v. 
softly	柔软地，温和地	adv. 
softness	柔软，温和	n. 
software	软件	n. 
soil	土壤，国土，污秽	n. 
solar	太阳的	adj. 
soldier	士兵，兵	n. 
sole	唯一的，单独的	adj. 
solely	唯一地，只	adv. 
solemn	正式的，严肃的	adj. 
solicitor	律师	n. 
solid	固体的，牢固的	adj. 
solidarity	团结	n. 
solitary	独自的，孤独的	adj. 
solitude	寂寞，独居	n. 
solo	独唱，独奏	n. 
solution	解决，溶液	n. 
solve	解答，溶解	v. 
solvency	偿付能力	n. 
solvent	有偿付能力的	adj. 
some	若干，某一	adj. 
somebody	某人，重要人物	pron. 
somehow	以某种方式	adv. 
someone	有人，某人	pron. 
something	某事，某物	pron. 
sometime	日后，曾经	adv. 
sometimes	有时，不时	adv. 
somewhat	稍微，有点	adv. 
somewhere	某地，到某处	adv. 
son	儿子	n. 
song	歌，歌词，鸟鸣	n. 
son-in-law	女婿	n. 
sonnet	十四行诗	n. 
sonyericsson	索尼愛立信通訊手機公司	n. 
soon	不久，很快，早	adv. 
soot	油烟，煤烟	n. 
soothe	安慰，使镇定	v. 
sophisticated	复杂的，先进的	adj. 
sophistication	世故	n. 
sore	疼痛的，恼火的	adj. 
sorrow	伤心，悲哀，忧患	n. 
sorrowful	悲哀的，忧愁的	adj. 
sorry	难过的，遗憾的	adj. 
sort	种类	n. 
soul	灵魂，心灵，人	v. 
sound	声，声音	n. 
soup	汤	n. 
sour	酸的，不高兴的	adj. 
source	来源，出处，源泉	n. 
south	南,南方	n. 
southeast	东南(部)	n. 
southern	南的，南方的	adj. 
southward	向南	adj. adv. 
southwest	西南(部)	n. 
souvenir	纪念品	n. 
sovereign	君主	n. 
sovereignty	主权	n. 
sow	播种，散布	v. 
soy	酱油	n. 
space	空间，太空，空地	n. 
spacecraft	宇宙飞船	n. 
spaceship	太空船，宇宙飞船	n. 
spaceshuttle	航天飞机	n. 
spacious	广阔的，宽敞的	adj. 
spade	铲子，铁锹，黑桃	n. 
spain	西班牙	n. 
span	跨度	n. 
spanish	西班牙人(的)	adj. n. 
spare	腾出时间	v. 
spark	火花，火星	n. 
sparkle	发火花，闪耀	v. 
sparrow	麻雀	n. 
spatial	空间的	adj. 
speak	说话，发言，讲	v. 
speaker	说话者，发言人	n. 
spear	矛，枪	n. 
special	特别的，专门的	adj. 
specialist	专家	n. 
specialize	专攻，专门研究	v. 
specialized	专业的，专门的	adj. 
specially	特地，专门地	adv. 
specialty	专业，专长	n. 
species	物种，种类	n. 
specific	特殊的，明确的	adj. 
specification	规格，明细表	n. 
specify	详细说明，指定	v. 
specimen	标本，样本	n. 
spectacle	眼镜，场面，壮观	n. 
spectacular	壮观的	adj. 
spectator	观众，旁观者	n. 
spectrum	光谱	n. 
speculate	推测，投机	v. 
speculation	推测，投机	n. 
speculator	投机商	n. 
speech	演说，语言能力	n. 
speed	速度	n. 
speedy	快速的	adj. 
spell	拼写，咒语	v. 
spelling	拼音，拼写	n. 
spend	花费，消耗	v. 
sphere	球体，范围，领域	n. 
spice	香料，调味品	n. 
spicy	辛辣的	adj. 
spider	蜘蛛	n. 
spill	溢出，流出	v. 
spin	自转，纺	v. 
spiral	螺旋(的)	adj. n. 
spirit	精神，心灵	n. 
spiritual	精神上的，心灵的	adj. 
spit	吐，倾吐	v. 
spite	恶意，怨恨	n. 
splash	溅，泼	v. 
splendid	辉煌的，灿烂的	adj. 
split	劈，分割	v. 
spoil	损坏，宠坏	v. 
spokesman	发言人	n. 
sponge	海绵	n. 
sponsor	发起人，主办者	n. 
sponsorship	发起，主办	n. 
spontaneous	自发的	adj. 
spoon	汤匙	n. 
spoonful	一匙的量	adj. 
sport	运动，嬉戏	v. 
sportsman	运动员	n. 
sportsmanship	体育精神	n. 
spot	点，斑，污点，场所	n. 
sprain	扭伤	v. n. 
spray	水雾	n. 
spread	伸开，散布，传播	v. 
spring	跳跃，萌芽	v. 
sprinkle	洒，撒，不细雨	v. 
sprout	幼芽	n. 
spur	刺激，鼓舞	n. v. 
spy	间谍	n. 
square	正方形，广场，平方	n. 
squash	压碎	v. 
squat	蹲	v. 
squeeze	压，榨，挤	v. 
squirrel	松鼠	n. 
stab	刺，戳	v. n. 
stability	稳定性	n. 
stable	稳固的，稳定的	adj. 
stack	推放，垛	n. v. 
stadium	露天运动场	n. 
staff	工作人员，棒子	n. 
stage	舞台，阶段	n. 
stagger	蹒跚	v. 
stagnation	停滞	n. 
stain	污点，瑕疵	n. 
stainless	无瑕的，不锈的	adj. 
stair	楼梯	n. 
staircase	扶手楼梯	n. 
stake	桩，赌注	n. 
stale	陈旧的	adj. 
stalk	主茎，叶柄	n. 
stall	厩，货摊	n. 
stammer	口吃，结巴	v. n. 
stamp	邮票，图章	n. 
stand	站立，坐落，忍受	v. 
standard	标准	n. 
standardize	标准化	v. 
standing	常务的	adj. 
standpoint	立场，观点	n. 
standstill	停顿	n. 
staple	钉书钉，主要产品	n. 
stapler	钉书机	n. 
star	星	n. 
stare	凝视	n. v. 
start	开始，着手，发动	v. 
starting	出发，开始	n. 
startle	惊吓，使吃惊	v. 
starvation	饥饿	n. 
starve	挨饿，渴求	v. 
state	状态，国家，州	n. 
statement	声明，陈述	n. 
statesman	政治家，国务活动家	n. 
static	静止的，静态的	adj. 
station	站，台	n. 
stationary	固定的，稳定的	adj. 
stationery	文具	n. 
statistical	统计的	adj. 
statistics	统计(学)	n. 
statue	雕像，铸像	n. 
status	形势，身分	n. 
statute	法令，章程，条例	n. 
stay	停留，暂住，保持	v. 
steadily	稳固地，稳步地	adv. 
steady	平稳的，稳健的	adj. 
steak	牛排，排骨	n. 
steal	偷窃	v. 
steam	汽，蒸汽	n. 
steamer	汽船	n. 
steel	钢	n. 
steep	陡峭的	adj. 
steer	驾驶，行驶	v. 
stem	茎	n. 
stencil	复写纸，蜡纸	n. 
step	脚步，台阶，步骤	n. 
stereo	立体声	n. 
sterling	英镑的	adj. 
stern	严厉的，坚决的	adj. 
stevedore	码头工人	n. 
stew	炖，煮	v. 
steward	乘务员，男仆	n. 
stewardess	女乘务员，空姐	n. 
stick	枝，杆，手杖	n. 
sticky	黏的	adj. 
stiff	僵硬的，生硬的	adj. 
still	静止的	adj. 
stillness	寂静，静止	n. 
stimulate	刺激，使兴奋	v. 
stimulation	刺激	n. 
sting	刺痛	n. 
stink	臭的	adj. 
stipulate	合同规定，约定	v. 
stipulation	规定	n. 
stir	搅拌，激起	v. 
stirring	动人的	adj. 
stitch	一针	n. 
stock	存货，股份	n. 
stocking	长袜	n. 
stomach	胃	n. 
stone	石头，石料，宝石	n. 
stony	石头多的	adj. 
stool	凳子	n. 
stoop	弯腰，屈从	v. 
stop	停止，终止	v. 
storage	贮藏，货栈	n. 
store	商店	n. 
storey	楼层	n. 
storm	暴风雨，暴怒	n. 
stormy	有暴风雨的	adj. 
story	故事，小说，经历	n. 
stout	肥胖的，结实的	adj. 
stove	炉子，火炉	n. 
stow	装载，理舱	v. 
stowage	装载	n. 
straight	直的	adj. 
straighten	弄直	v. 
straightforward	直爽的	adj. 
strain	拉紧，扭伤，使紧张	v. 
strait	海峡	n. 
strand	(绳)股，缕	n. 
strange	奇怪的，陌生的	adj. 
stranger	新人，陌生人	n. 
strap	带，皮带	n. 
strategic	战略的	adj. 
strategy	战略，策略，计谋	n. 
straw	麦杆，稻草，吸管	n. 
strawberry	草莓	n. 
stray	迷路	v. 
streak	纹理，条纹	n. 
stream	小溪，流	n. 
streamline	流线型	n. 
street	大街	n. 
streetcar	有轨电车	n. 
strength	力气，力量，强度	n. 
strengthen	加强，巩固	v. 
stress	强调，压力	v. n. 
stretch	伸展，拉长	v. 
strict	严格的，精确的	adj. 
strictly	严格地，绝对	adv. 
stride	阔步走	adv. 
strife	冲突，争斗	n. 
strike	打，攻击，罢工	v. 
striking	引人注目的	adj. 
string	细绳，弦，一串	n. 
strip	剥	v. 
stripe	条纹	n. 
strive	努力，奋斗	v. 
stroke	敲，笔划	n. 
stroll	散步，闲逛	v. n. 
stroller	散步者	n. 
strong	强壮的，强烈的	adj. 
stronghold	堡垒，要塞	n. 
strongly	强烈地，强有力地	adv. 
structural	结构的，组织上的	adj. 
structure	结构，构造，组织	n. 
struggle	斗争，奋斗	v. n. 
stubborn	顽固的，倔强的	adj. 
student	学生，研究人员	n. 
studio	画室，工作间	n. 
study	学习，研究	v. n. 
stuff	材料，东西	n. 
stuffy	闷热的，不透气的	adj. 
stumble	绊跌	v. 
stump	树桩，残茬	n. 
stupid	愚蠢的，迟钝的	adj. 
stupidity	愚蠢	n. 
sturdy	健壮的	adj. 
style	风格，时尚，作风	n. 
stylist	时装设计师	n. 
subdivide	细分，再分	v. 
subdue	战胜，征服	v. 
subject	题目，学科，主语	n. 
subjective	主观的	adj. 
subjunctive	虚拟的	adj. 
submarine	海底的	adj. 
submerge	浸没，淹没	v. 
submit	服从，呈交	v. 
subordinate	下级的，辅助的	adj. 
subordination	服从	n. 
subscribe	订购，订阅	v. 
subscription	预订，订购	n. 
subsequence	后果	n. 
subsequent	以后的，后起的	adj. 
subsequently	后来，其后	adv. 
subsidiary	辅助的，次要的	adj. 
substance	物质，实质	n. 
substantial	可观的，实质的	adj. 
substantiate	证实	v. 
substitute	代替，代用品	n. v. 
substitution	代替	n. 
subtle	敏锐的，微妙的	adj. 
subtract	减去	v. 
subtraction	减法，减去	n. 
suburb	郊区，郊外	n. 
suburban	郊区的	adj. 
subway	地铁	n. 
succeed	成功，后继	v. 
success	成功	n. 
successful	成功的	adj. 
successfully	成功地	adv. 
succession	接连，继任	n. 
successive	接连的，连续的	adj. 
successor	继承人，继任者	n. 
such	这样的，如此的	adj. 
suck	吮，咂	v. 
sudden	突然的，意外的	adj. 
suddenly	突然，忽然	adv. 
suffer	遭受，受苦，忍受	v. 
suffering	苦难	n. 
suffice	足够，满足需要	v. 
sufficient	充足的，充分的	adj. 
sufficiently	充分地，足够地	adv. 
suffix	后缀	n. 
sugar	糖	n. 
suggest	建议，暗示	v. 
suggestion	建议，示意	n. 
suicide	自杀	n. 
suit	一身西服，起诉	n. 
suitable	合适的，适宜的	adj. 
suitcase	手提箱	n. 
suite	随员，一套(房间)	n. 
sullen	板着脸的	adj. 
sultry	闷热的	adj. 
sum	总数，会计	n. 
summarize	概括，总结	v. 
summary	概要	n. 
summer	夏季	n. 
summit	顶峰，最高点	n. 
summon	召唤，召集	v. n. 
sun	太阳，阳光	n. 
sunburn	晒黑	v. 
sunday	星期日	n. 
sunflower	葵花	n. 
sunlight	阳光	n. 
sunny	向阳的，晴朗的	adj. 
sunrise	日出	n. 
sunset	日落	n. 
sunshine	日照，日光	n. 
super	特级的，超级的	adj. 
superb	华丽的，超等的	adj. 
superficial	表面的，肤浅的	adj. 
superinrtendent	管理人，负责人	n. 
superior	优良的，上级的	adj. 
superiority	优越(性)	n. 
supermarket	超级市场	n. 
supersede	代替	v. 
supersonic	超音速的	adj. 
superstition	迷信	n. 
superstitious	迷信的	adj. 
supervise	管理，监督，监考	v. 
supervision	监督	n. 
supervisor	监考人，监查	n. 
supper	晚餐	n. 
supplement	增补，补充	n. v. 
supplementary	补充的	adj. 
supplier	供应商	n. 
supply	供应，供给	v. 
support	支持，资助，支援	v. 
supporter	支持者	n. 
suppose	猜想，假设	v. 
supposing	假使	conj. 
suppress	镇压，压制，遏止	v. 
suppression	镇压，压制	n. 
supreme	最高的	adj. 
surcharge	附加费，超载	n. 
sure	有把握的，一定的	adj. 
surely	一定，肯定，谅必	adv. 
surface	表面	n. 
surge	汹涌，波动	n. v. 
surgeon	外科医生	n. 
surgery	外科(学)	n. 
surmise	猜想，推测	v. n. 
surname	姓	n. 
surpass	超过，胜过	v. 
surplus	过剩	n. 
surprise	使惊诧	v. 
surprising	惊人的	adj. 
surrender	放弃，交出，投降	v. 
surround	包围	v. 
surroundings	环境，周围事物	n. 
survey	视察，测量	v. 
surveyor	调查人，检验人	n. 
survival	幸存，遗风	n. 
survive	幸免于，幸存	v. 
survivor	幸存者	n. 
suspect	怀疑	v. 
suspend	吊，悬，暂停，停学	v. 
suspense	暂停，中止	n. 
suspicion	怀疑，嫌疑	n. 
suspicious	可疑的，猜疑的	adj. 
sustain	支撑，遭受	v. 
swallow	燕子	n. 
swamp	沼泽	n. 
swan	天鹅	n. 
swarm	群	n. 
sway	摇晃，影响	v. 
swear	宣誓，诅咒	v. 
sweat	出汗	v. 
sweater	运动衫，毛衣	n. 
swede	瑞典人	n. 
sweden	瑞典	n. 
swedish	瑞典人(的)	adj. n. 
sweep	扫除，席卷	v. 
sweet	甜的，甜蜜的	adj. 
sweeten	变甜，加糖	v. 
sweetheart	心肝，宝贝	n. 
sweetness	甜味	n. 
swell	膨胀，肿	v. 
swift	快的，迅速的	adj. 
swim	游泳，游	v. 
swing	摇摆	v. 
swiss	瑞士人	n. 
switch	转换	v. 
switzerland	瑞士	n. 
sword	剑	n. 
syllable	音节	n. 
symbol	象征，符号	n. 
symbolize	象征	v. 
symmetric	对称的，匀称的	adj. 
symmetry	对称	n. 
sympathetic	同情的，有共鸣的	adj. 
sympathize	同情	v. 
sympathy	同情，同感，共鸣	n. 
symphony	交响乐	n. 
symposium	座谈会，学术讨论会	n. 
symptom	症状，征兆	n. 
synonym	同义词	n. 
synthesis	综合，合成	n. 
synthetic	合成的，人造的	adj. 
system	系统，体制，制度	n. 
systematic	系统的，有组织的	adj. 
systematically	有系统地	adv. 
table	桌子，表格	n. 
tablet	药片	n. 
tabulate	制表，将...列表	v. 
tack	图钉	n. 
tackle	用具，辘轳	n. 
tact	机敏，圆滑	n. 
tactful	机智的，老练的	adj. 
tactics	战术，策略	n. 
tag	标签，货签	n. 
tail	尾巴，尾部	n. 
tailor	裁缝	n. 
take	拿，带，吃，乘	v. 
take-off	起飞	n. 
tale	故事	n. 
talent	人才，天资	n. 
talk	谈话	v. 
talkative	罗嗦的	adj. 
tall	高的	adj. 
tally	吻合，符合	v. 
tame	驯养，制报	v. 
tan	黄褐色	n. 
tangle	缠绕，纠缠	v. 
tank	油箱，水箱，坦克	n. 
tanker	油轮	n. 
tap	叩击	v. 
tape	条，带，磁带	n. 
tape-recorder	录音机	n. 
tape-recording	录音	n. 
tar	沥青，柏油	n. 
tare	皮重	n. 
target	目标，对象，靶	n. 
tariff	关税	n. 
task	工作，任务	n. 
taste	味道，趣味	n. 
tasteful	有滋味的，好吃的	adj. 
tax	税	n. 
taxation	税(总称)，税务	n. 
taxi	出租汽车	n. 
tea	茶，茶叶	n. 
teach	教，教书，教导	v. 
teacher	教员，老师	n. 
teaching	教学，教导	n. 
teacup	茶杯	n. 
team	小队	n. 
teapot	茶壶	n. 
tear	眼泪	n. 
tease	取笑，逗乐	v. 
technical	技术的，技能的	adj. 
technician	技术员，技师	n. 
technique	技术，技巧	n. 
technological	技术的，工艺的	adj. 
technology	技术，工艺	n. 
tedious	腻烦的，乏味的	adj. 
teenager	(十几岁的)少年	n. 
teens	十多岁	n. 
telefax	传真	n. 
telegram	电报	n. 
telegraph	电报	n. 
telephone	电话	n. 
telescope	望远镜	n. 
television	电视，电视机	n. 
telex	电传	n. 
tell	告诉，讲，说出	v. 
teller	出纳	n. 
tempatation	诱惑，引诱	n. 
temper	情绪，脾气	n. 
temperature	温度，体温	n. 
temple	庙，寺院，太阳穴	n. 
temporary	暂时的，临时的	adj. 
tempt	引诱，诱惑	v. 
ten	十	num. 
tenant	房客，承租人	n. 
tend	趋向，照料，投标	v. 
tendency	趋势，倾向	n. 
tender	投标人	n. 
tenis	网球	n. 
tenor	(支票)限期	n. 
tense	紧张的	adj. 
tension	紧张状态，张力	n. 
tent	帐篷	n. 
tentative	试探性的	adj. 
tenth	第十，十分之一	num. 
term	期限，学期，术语	n. 
terminable	可终止的	adj. 
terminal	终点	n. 
terminate	终止，结束	v. 
termination	终止，结束	n. 
terminology	术语(总称)	n. 
terrace	平台，台阶	n. 
terrible	可怕的，极度的	adj. 
terribly	可怕地，极	adv. 
terrific	了不起的，极好的	adj. 
terrify	惊吓，使恐怖	v. 
territory	领土，领域，地区	n. 
terror	恐怖，令人恐怖的事	n. 
terrorism	恐怖主义	n. 
terrorist	恐怖分子	n. 
test	测验，试验	v. n. 
testify	证明，证实	v. 
testimony	证据	n. 
text	正文，课文，原文	n. 
textbook	课本，教科书	n. 
textile	纺织品	n. 
textual	课文的，正文的	adj. 
than	比，除...外	conj. 
thank	谢谢，感谢	v. 
thankful	感谢的，欣慰的	adj. 
thanks	感谢	n. 
that	那,那个	adj. 
theatre	剧场，戏剧，舞台	n. 
theatrical	戏剧的	adj. 
theft	偷盗	n. 
their	他们的，它们的	adj. 
them	他(她)们，它们	pron. 
theme	主题，题目	n. 
themselves	他们、它们自己	pron. 
then	当时，然后，那么	adv. 
theoretical	理论的	adj. 
theory	理论，学说	n. 
there	那里，到那里	adv. 
thereafter	此后，其后	adv. 
thereby	因此，由此	adv. 
therefor	为此	adv. 
therefore	因而，所以	adv. 
therefrom	由此	adv. 
therein	在那里，其中	adv. 
thereof	及其，由此，它的	adv. 
thereon	关于那	adv. 
therewith	对此	adv. 
thermometer	温度计	n. 
these	这些	pron. 
thesis	论文	n. 
they	他(她)们，它们	pron. 
thick	厚的，浓的	adj. 
thicken	加厚，变浓	v. 
thickness	厚，厚度，浓	n. 
thief	窃贼，小偷	n. 
thigh	大腿	n. 
thin	薄的，瘦的	adj. 
thing	东西，事情	n. 
think	想，相信，认为	v. 
thinker	思想家	n. 
thinking	思想	n. 
third	第三，三分之一	num. 
thirst	渴，渴望	n. 
thirsty	渴的，渴望的	adj. 
thirteen	十三	num. 
thirty	三十	num. 
this	这，这个	adj. pron. 
thorn	刺，荆棘	n. 
thorough	充分的，彻底的	adj. 
thoroughly	充分地，彻底地	adv. 
those	那些	pron. adj. 
though	虽然，可是	conj. 
thought	想法，思想，关怀	n. 
thoughtful	深思的，体贴的	adj. 
thoughtless	轻率的，粗心的	adj. 
thousand	千	num. 
thrash	抽打	v. 
thread	线，思路	n. 
threat	恐吓，威胁	n. 
threaten	恐吓，威胁	v. 
three	三	num. 
threshold	开端，门槛	n. 
thrift	节俭	n. 
thrifty	节俭的	adj. 
thrill	发抖	v. 
thriller	惊险小说，电影	n. 
thrive	兴旺，繁荣	v. 
throat	咽喉	n. 
throne	王位	n. 
throng	一群人	n. 
through	通过，借助	prep. 
throughout	贯穿	prep. 
throw	投，扔，抛	v. n. 
thrust	强推，插入，刺	v. 
thumb	拇指	n. 
thumbtack	按钉，图钉	n. 
thunder	雷	n. 
thunderstorm	雷雨	n. 
thursday	星期四	n. 
thus	如此，这样，因而	adv. 
tick	滴答声	n. 
ticket	票，标签，价目单	n. 
tickle	挠，搔，逗乐	v. 
tide	潮汐，潮流	n. 
tidy	整齐的，整洁的	adj. 
tie	捆，打结	v. 
tie-up	(资金)占用，冻结	n. 
tiger	虎	n. 
tight	紧的，密封的	adj. 
tighten	拉紧	v. 
tightly	紧紧地，紧密地	adv. 
tigress	母虎	n. 
tile	瓦，瓷砖	n. 
till	直到	prep. 
tilt	倾斜	v. n. 
timber	木材	n. 
time	时间，时候，次数	n. 
timely	及时的	adj. 
timetable	时刻表，时间表	n. 
timid	胆怯的，害羞的	adj. 
tin	锡，锡器	n. 
tiny	微小的	adj. 
tip	梢，尖，小费	n. 
tiptoe	用脚尖走	v. 
tire	疲劳，厌倦	v. 
tired	疲劳的，厌倦的	adj. 
tiresome	使人厌倦的	adj. 
tissue	组织，卫生纸	n. 
title	标题，题目，称号	n. 
to	向，到	prep. 
toad	蟾蜍，癞蛤蟆	n. 
toast	烤面包，祝酒	n. 
tobacco	烟草	n. 
today	今天,现在	adv. 
toe	脚趾，鞋头	n. 
together	共同，一起，同时	adv. 
toil	苦干	v. 
toilet	卫生间，便桶	n. 
token	象征，纪念章	n. 
tolerable	可容忍的	adj. 
tolerance	宽容，容忍	n. 
tolerant	宽容的，宽大的	adj. 
tolerate	容忍，宽容	v. 
toll	税	n. 
tomato	蕃茄，西红柿	n. 
tomb	坟	n. 
tombstone	墓碑	n. 
tomorrow	明天	n. 
ton	吨	n. 
tone	语气，腔调，市况	n. 
tongue	舌，语言	n. 
tonight	今晚	n. 
tonnage	吨位，吨数	n. 
tonne	公吨	n. 
too	也，非常	adv. 
tool	工具，手段	n. 
tooth	牙齿	n. 
toothache	牙疼	n. 
toothbrush	牙刷	n. 
toothpaste	牙膏	n. 
top	顶，盖子	n. 
topic	课题，主题	n. 
torch	火炬，手电筒	n. 
torment	折磨，虐待	v. n. 
torpedo	鱼雷	n. 
torrent	激流，山洪	n. 
tortoise	龟	n. 
torture	拷打，折磨	v. n. 
toss	向上扔，颠簸，辗转	v. 
total	总	adj. 
totally	统统，完全地	adv. 
touch	碰，接触，触动	v. 
tough	坚韧的，难嚼烂的	adj. 
tour	旅行，周游	n. v. 
tourism	旅游业	n. 
tourist	旅游者，游客	n. 
tow	拖，牵引	v. n. 
toward	向，对于，将近	prep. 
towel	毛巾	n. 
tower	塔	n. 
town	市镇，城市，闹市	n. 
toy	玩具	n. 
trace	痕迹，微量	n. 
track	径赛，轨道，路径	n. 
tractor	拖拉机	n. 
trade	贸易，交换	n. 
trademark	商标	n. 
trader	商人	n. 
tradesman	商人	n. 
tradition	传统，惯例	n. 
traditional	传统的	adj. 
traffic	交通，交易，运输	n. 
tragedy	悲剧，惨事，灾难	n. 
tragic	悲剧的，悲惨的	adj. 
trail	拖曳，尾随	v. 
train	列车，一列	n. 
trainee	受训练者	n. 
trainer	教练	n. 
training	训练	n. 
traitor	叛徒	n. 
tram	有轨电车	n. 
tramp	跋涉，流浪者	n. 
trample	践踏，蹂躏	v. 
tranquil	平静的，安宁的	adj. 
transact	交易	v. 
transaction	交易	n. 
transcient	短暂的，瞬时的	adj. 
transfer	转移，转让	v. 
transferable	可转让的	adj. 
transform	转变，转化	v. 
transformation	转化，转变	n. 
transformer	变压器	n. 
transistor	晶体管(收音机)	n. 
transit	运输，转运	v. 
transition	过渡，转变	n. 
translate	翻译	v. 
translation	翻译，译文	n. 
translator	译音	n. 
transmission	传送，播送	n. 
transmit	传播，传导，发射	v. 
transparent	透明的	adj. 
transplant	移植	v. 
transport	运送	v. 
transportation	运输，交通	n. 
transship	转运，转船	v. 
transshipment	转运	n. 
transverse	横向的，横断的	adj. 
trap	陷井，圈套	n. 
travel	旅行，传导	v. 
traveler	旅行者	n. 
traverse	横断，横过	n. v. 
tray	托盘	n. 
tread	踩，践踏	v. 
treason	谋反，叛国	n. 
treasure	财宝，珍宝	n. 
treasurer	司库	n. 
treat	对待，医治，论述	v. 
treatment	待遇，疗法	n. 
treaty	条约	n. 
tree	树	n. 
tremble	哆嗦，发抖	v. 
tremendous	巨大的，惊人的	adj. 
trench	沟，壕	n. 
trend	走向，趋势	n. 
trial	审讯，尝试，试验	n. 
triangle	三角(形)	n. 
triangular	三角形的，三方的	adj. 
tribe	部落	n. 
tribute	颂词，献礼	n. 
trick	诡计，骗局，伎俩	n. 
trickle	滴下，流下	v. 
tricky	巧妙的，狡猾的	adj. 
trifle	小事，琐事	n. 
trigger	扳机	n. 
trim	修剪，修整	v. 
trip	旅行，远足	n. 
triple	三倍的，三重的	adj. 
triplicate	一式二份	n. 
triumph	胜利	n. 
triumphant	得胜的，得意的	adj. 
trivial	琐碎的	adj. 
trolley	手推车，电车	n. 
troop	队，军队	n. 
tropic	回归线，热带	n. 
tropical	热带的	adj. 
trot	小跑，快步走	v. n. 
trouble	麻烦	n. v. 
troublesome	讨厌的，麻烦的	adj. 
trousers	裤子	n. 
truck	卡车，载重汽车	n. 
truly	真正地，确实	adv. 
trumpet	喇叭	n. 
trunk	树干，躯干，皮箱	n. 
trust	委托，信任，信托	n. 
truth	真相，真理	n. 
truthful	诚实的，真正的	adj. 
try	尝试，审讯	v. 
tub	浴缸，木盆	n. 
tub	浴	n. 
tube	管子，试管	n. 
tuberculosis	结核，肺结核	n. 
tuck	卷起，塞进	v. 
tuesday	星期二	n. 
tug	用力拖，拖船	v. n. 
tuition	学费	n. 
tulip	郁金香	n. 
tumble	跌倒，摔跤，打滚	v. 
tumult	骚动，暴动，吵闹	n. 
tuna	金枪鱼	n. 
tune	调子	n. 
tunnel	隧道，地道，坑道	n. 
turbine	汽轮机，涡轮机	n. 
turbulent	骚动的	adj. 
turk	土耳其人	n. 
turkey	土耳其	n. 
turn	转向，旋转	v. 
turning	拐角	n. 
turnip	萝卜	n. 
turnover	周转，营业额	n. 
turtle	海龟	n. 
tutor	辅导教师	n. 
twelfth	第十二	num. 
twelve	十二	num. 
twentieth	第二十	num. 
twenty	二十	num. 
twice	两次，两倍	adv. 
twig	细枝	n. 
twilight	黎明，黄昏，微亮	n. 
twin	孪生(的)	n. adj. 
twinkle	闪烁，眨眼	v. n. 
twist	拧，扭，搓，歪曲	v. 
two	二	num. 
type	类型，典型	n. 
typewriter	打字机	n. 
typhoon	台风	n. 
typical	典型的	adj. 
typist	打字员	n. 
tyranny	暴政，暴行	n. 
tyrant	暴君，专制	n. 
tyre	轮胎	n. 
ugly	丑恶的，丑陋的	adj. 
ulcer	溃疡	n. 
ultimate	最终的，极限的	adj. 
ultimately	最后，终究	adv. 
ultimo	上月的	adj. 
ultrasonic	超声速的	adj. 
ultraviolet	紫外的	adj. 
umbrella	伞，保护伞	n. 
unable	不能的，不会的	adj. 
unacceptable	不能接受的	adj. 
unaccommodating	不青通融的	adj. 
unaffordable	买不起的	adj. 
unanimous	一致的	adj. 
unavoidable	不可避免的	adj. 
unbearable	不可忍受的	adj. 
uncertain	不确定的，易变的	adj. 
uncertainty	不定，易变	n. 
uncle	伯、叔、舅、姑父	n. 
uncomfortable	不舒服的	adj. 
uncommon	罕见的，不常见的	adj. 
unconditionally	无条件地	adv. 
unconscious	无知觉的	adj. 
uncover	揭开	v. 
under	在...下面	prep. 
underestimate	低估	v. 
undergo	经受，经历	v. 
undergraduate	本科生	n. 
underground	地下的，秘密的	adj. 
underline	在...下划线，强调	v. 
underlying	根本的，在下面的	adj. 
undermentioned	下述的	adj. 
undermine	破坏	v. 
underneath	在...下面	prep. 
undersigned	在...下面签名的	adj. 
understand	了解，懂，熟悉	n. 
understanding	理解，谅解	n. 
undertake	从事，承担	v. 
undertaking	事业，许诺	n. 
underwear	内衣	n. 
underwriter	保险商，承购人	n. 
undo	解开，取消	v. 
undoubtedly	无容置疑地	adv. 
undue	过分的，不适当的	adj. 
unduly	过分地，不适当地	adv. 
uneasy	不自在的，担心的	adj. 
unemloyment	失业	n. 
unexpected	意外的，未料到的	adj. 
unfair	不公平的	adj. 
unfit	不合适的	adj. 
unfold	展示，摊开	v. 
unfortunate	不幸的，遗憾的	adj. 
unfortunately	不幸地，不凑巧	adv. 
unhappy	不幸福的	adj. 
uniform	均匀的，统一的	adj. 
uniformly	单调地，一样地	adv. 
uninterested	不感兴趣的	adj. 
union	联合，联盟，联合会	n. 
unique	唯一的	adj. 
unit	单位，个体	n. 
unite	统一，联合，团结	v. 
united	联合的	adj. 
unity	统一，团结	n. 
universal	宇宙的，普遍的	adj. 
universally	普遍地	adv. 
universe	宇宙	n. 
university	大学	n. 
unjust	不公正的	adj. 
unkind	不仁慈的，冷酷的	adj. 
unknown	未知的	adj. 
unlawful	不合法的，违法的	adj. 
unless	除非	prep. 
unlike	不同的	adj. 
unlikely	未必的，不象的	adj. 
unlimited	无限的	adj. 
unload	卸货，卸除	v. 
unlock	开启，揭开	v. 
unlucky	不幸的，倒霉的	adj. 
unmerchantable	无销路的	adj. 
unnecessary	不必要的	adj. 
unobtainable	无法得到的	adj. 
unpaid	未付的	adj. 
unpleasant	令人不愉快的	adj. 
unprecedented	前所未有的	adj. 
unprecedentedly	空前地	adv. 
unreasonable	不合理的，贵的	adj. 
unsalable	不好销售的	adj. 
unsatisfactory	不令人满意的	adj. 
unstable	不稳定	adj. 
unsuitable	不适宜的	adj. 
untie	解开	v. 
until	到...为止	prep. 
unusable	无法使用的	adj. 
unusual	不寻常的	adj. 
unwarranted	无根据的	adj. 
unwelcome	不受欢迎的	adj. 
unwilling	不愿意的	adj. 
unworkable	行不通的	adj. 
up	向上，起床	adv. 
upcreep	(价格)上涨	n. 
uphold	支持，维持	v. 
upon	在...之上	prep. 
upper	上部的，较高的	adj. 
upright	直立的，正直的	adj. 
uproar	喧闹，轰鸣	n. 
upset	倾覆，打乱，使心烦	v. 
upside	上面，上部	n. 
upside-down	颠倒的，倒置的	adj. 
upstairs	在楼上，往楼上	adv. 
up-to-date	时新的，最近的	adj. 
upward	向上(的)	adv. adj. 
uranium	铀	n. 
urban	都市的，城市的	adj. 
urge	敦促，推动	v. 
urgent	紧迫的，紧急的	adj. 
urgently	紧急地	adv. 
us	我们(宾格)	pron. 
usage	使用，惯用法	n. 
use	使用	v. 
useful	有用的，有益的	adj. 
usefulness	用处，有效性	n. 
useless	无用的	adj. 
user	使用者，用户	n. 
usual	通常的，习惯性的	adj. 
usually	通常，平常	adv. 
utensil	用具，器皿	n. 
utility	效用，公用事业	n. 
utilization	利用	n. 
utilize	利用	v. 
utmost	最大的，最高的	adj. 
utter	说,发声	v. 
utterance	说话	n. 
vacacy	空缺，空位	n. 
vacant	空的，闲置的	adj. 
vacation	假期	n. 
vaccinate	接种疫苗	v. 
vaccination	接种	n. 
vacuum	真空	n. 
vague	含糊的，不清楚的	adj. 
vain	徒然的，自负的	adj. 
vainly	徒劳地	adv. 
valian	坏蛋	n. 
valid	正当的，有效的	adj. 
validity	有效，确实	n. 
valley	山谷	n. 
valuable	宝贵的，有价值的	adj. 
value	价值	n. 
valued	宝贵的	adj. 
valve	阀门	n. 
van	小货车，面包车	n. 
vanish	消失，消散	v. 
vanity	虚荣心，浮华	n. 
vapor	水汽，蒸汽	n. 
variable	可变的	adj. 
variance	分歧，不一致	n. 
variant	不同的，不一致的	adj. 
variation	变化，变更	n. 
varied	不同的	adj. 
variety	多样(性)，品种	n. 
various	各种各样的	adj. 
varnish	清漆	n. 
vary	变化，使多样化	v. 
vase	花瓶	n. 
vast	巨大的，宏大的	adj. 
vault	拱顶	n. 
vegetable	蔬菜，植物	n. 
vehicle	运载工具	n. 
veil	面纱，账，托辞	n. 
vein	静脉，矿脉，脉	n. 
velocity	速度，速率	n. 
velvet	丝绒	n. 
vender	商贩	n. 
vengeance	报复，复仇	n. 
ventilate	换气，自由讨论	v. 
ventilation	通风	n. 
venture	冒险	n. v. 
venus	金星	n. 
verb	动词	n. 
verbal	文字的，口头的	adj. 
verge	边缘，界限	n. 
verification	检验	n. 
verify	检验，证实	v. 
versatile	多才多艺的	adj. 
verse	诗，韵文	n. 
version	译文，译本，看法	n. 
versus	对	prep. 
vertical	垂直的	adj. 
very	很，非常	adv. 
vessel	船只，容器，血管	n. 
vest	背心，汗衫	n. 
veteran	老手，老兵	n. 
veto	否决(权)	v. n. 
vex	使烦恼	v. 
via	经由，取道	prep. 
vibrate	振动，战栗	v. 
vibration	振动，颤动	n. 
vice	坏事，恶习	n. 
vicinity	邻近，附近，接近	n. 
vicious	邪恶的，不道德的	adj. 
victim	受害者	n. 
victorious	胜利的，成功的	adj. 
victory	胜利	n. 
video	电视的，视频的	adj. 
view	视域，景色，见解	n. 
viewer	观察者，电视观众	n. 
viewpoint	观点，看法	n. 
vigor	活动，精力，元气	n. 
vigorous	精力旺盛的	adj. 
villa	别墅	n. 
village	村庄	n. 
villain	坏蛋	n. 
vine	藤，葡萄树	n. 
vinegar	醋	n. 
violate	违犯，违背	v. 
violation	违犯，侵犯	n. 
violence	猛烈，暴力，暴行	n. 
violent	猛烈的，暴力的	adj. 
violet	紫罗兰，紫色	n. 
violin	小提琴	n. 
virgin	处女的	adj. 
virtual	实质上的	adj. 
virtually	几乎，差不多	adj. 
virtue	善，美德，优点	n. 
virus	病毒	n. 
visa	签证	n. 
viscous	粘的	adj. 
visible	看得见的	adj. 
vision	视觉，视力，想象力	n. 
visit	访问，参观	v. n. 
visitor	客人，来宾，来访者	n. 
visual	视觉的	adj. 
vital	必不可少的	adj. 
vitamin	维生素	n. 
vivid	鲜艳的	adj. 
vividly	生动地	adv. 
vividness	生动(性)	n. 
vocabulary	词汇，词汇表、量	n. 
vocation	职业	n. 
vogue	时尚，时髦	n. 
voice	声音，嗓音	n. 
voiceless	无声的	adj. 
void	空的，无效的	adj. 
volcano	火山	n. 
volley	齐射	n. v. 
volleyball	排球	n. 
volt	伏特	n. 
voltage	电压	n. 
volume	卷，册，量，体积	n. 
voluntary	自愿的，志愿的	adj. 
volunteer	志愿者	n. 
vote	投票(权)，得票数	n. 
voter	投票人，选举人	n. 
voting	有投票权的	adj. 
vouch	担保	v. 
voucher	凭证，收据	n. 
vow	许愿，发誓	v. n. 
vowel	元音	n. 
voyage	航行	n. v. 
vulgar	低级趣味的	adj. 
vulnerability	易损性	n. 
vulnerable	晚受损害的	adj. 
wade	消，跋涉	v. 
wag	摇，摆	v. 
wage	工资	n. 
wagon	货车	n. 
waist	腰(部)	n. 
wait	等候，伺候	v. 
waiter	服务员，侍者	n. 
waitress	女服务员	n. 
waive	放弃(要求、权利)	v. 
wake	醒来	v. 
waken	唤醒，使觉醒	v. 
walk	步行，走	v. 
walker	步行者，散步者	n. 
wall	墙壁	n. 
wallet	钱夹	n. 
walnut	核桃	n. 
wander	徘徊，离题，迷失	v. 
want	想要，通辑	v. 
war	战争，斗争	n. 
ward	病房，牢房	n. 
wardrobe	衣柜	n. 
ware	货物	n. 
warehouse	仓库，货栈	n. 
warehousing	仓储	n. 
warfare	战争(状态)	n. 
warm	温暖的，热情的	adj. 
warmly	热烈地，热情地	adv. 
warmth	温暖，暖和，热烈	n. 
warn	警告，预先通知	v. 
warning	警告	n. 
warrant	许可证，正当理由	n. 
warranted	担保的	adj. 
warranty	担保，保证	n. 
warrior	勇士，战士	n. 
warship	军舰	n. 
wash	洗，冲走	v. 
washing-machine	洗衣机	n. 
wasp	黄蜂，马蜂	n. 
waste	浪费	v. 
wasteful	浪费的，挥霍的	adj. 
watch	观看，看过	v. 
watchful	注意的，警惕的	adj. 
water	水	n. 
waterfall	瀑布	n. 
waterfront	水边，滩	n. 
waterproof	防水的	adj. 
watertight	不透水的	adj. 
watery	水汪汪的，淡的	adj. 
watt	瓦特	n. 
wave	波浪，波	n. 
wavelength	波长	n. 
waver	晃动，动摇	n. 
waving	波浪状的	adj. 
wax	蜡	n. 
way	方法，路，方向	n. 
we	我们	pron. 
weak	弱的，差的	adj. 
weakness	弱点，软弱	n. 
wealth	财富，丰富	n. 
wealthy	富裕的，富庶的	adj. 
weapon	武器	n. 
wear	穿，戴，磨损，耐久	v. 
weary	疲倦的	adj. 
weather	天气	n. 
weave	编织	v. 
weaver	织布工，编织者	n. 
web	网，蛛网，圈套	n. 
wedding	婚礼	n. 
wedge	楔子，起因	n. 
wednesday	星期三	n. 
weed	杂草	n. 
week	星期，周，工作周	n. 
weekday	工作日	n. 
weekend	周末	n. 
weekly	每周的	adj. 
weep	哭泣，哀悼	v. 
weigh	重...，称，权衡	v. 
weight	重量，重担，重物	n. 
welcome	受欢迎的	adj. 
weld	焊接	v. 
welfare	福利	n. 
well	井	n. 
well-known	有名的，著名的	adj. 
west	西方	n. 
western	西的，西方的	adj. 
westerner	西方人，欧美人	n. 
westward	向西(的)	adj. adv. 
wet	湿的，多雨的	adj. 
whale	鲸	n. 
whaling	捕鲸(业)	n. 
wharf	码头，停泊处	n. 
what	什么	pron. 
whatever	无论什么	pron. 
wheat	小麦	n. 
wheel	轮，车轮	n. 
when	何时	adv. 
whenever	无论何时	conj. 
where	哪里	adv. 
whereabouts	下落	n. 
whereas	而，却	conj. 
whereby	借此	adv. 
wherein	在何处	adv. 
wherever	无论哪里	adv. 
whether	是否，还是...	conj. 
which	哪个，那个	pron. adj. 
whichever	无论哪个	pron. 
while	一会儿	n. 
whilst	当...时，尽管	conj. 
whip	抽打，搅	v. 
whirl	旋转，飞转	v. n. 
whisker	络腮胡子	n. 
whisky	威士忌洒	n. 
whisper	耳语，发飒飒声	v. n. 
whistle	吹哨，鸣笛，啸叫	v. 
white	白的	adj. 
whitewash	粉刷，掩饰	v. 
who	谁	pron. 
whoever	无论谁	pron. 
whole	全部的	adj. 
wholesale	批发	n. v. 
wholesaler	批发商	n. 
wholesaling	批发	n. 
wholesome	卫生的	adj. 
wholly	完全，一概	adv. 
whom	谁(宾格)	pron. 
whose	谁的	pron. 
why	为什么	adv. 
wicked	坏的，不道德的	adj. 
wide	宽的，广阔的	adj. 
widely	广泛地，非常	adv. 
widen	加宽，扩大	v. 
widespread	流传广泛的	adj. 
widow	寡妇	n. 
widower	鳏夫	n. 
width	宽度	n. 
wield	挥动，行使	v. 
wife	妻子，夫人	n. 
wild	野生的，狂暴的	adj. 
wilderness	荒原	n. 
will	将，愿	v. 
willing	乐意的，自愿的	adj. 
willingly	乐意地，自愿地	adv. 
willingness	乐意，自愿	n. 
willow	柳树	n. 
win	赢得，成功	v. 
wind	风，风声	n. 
winding	弯曲的，蜿蜒的	adj. 
windmill	风车	n. 
window	窗户	n. 
windowsill	窗台	n. 
windy	刮风的	adj. 
wine	酒，葡萄酒	n. 
winery	酿酒厂	n. 
wing	翅膀，翼，派别	n. 
wink	眨眼，使眼色	v. 
winner	得胜者，获奖者	n. 
winter	冬季	n. 
wipe	擦，抹掉	v. 
wire	金属线，电线	n. 
wireless	无线电	adj. n. 
wisdom	智慧，明智	n. 
wise	智慧的，博学的	adj. 
wish	希望，祝愿，想要	v. 
wit	机智，才智	n. 
with	同...一起，用	prep. 
withdraw	撤消，退出，提款	v. 
withdrawal	撤退，取款	n. 
wither	枯萎，凋谢，衰弱	v. 
withhold	坚持	v. 
within	在...内	prep. 
without	没有，在...外部	prep. 
withstand	抵挡，顶住	v. 
witness	目击者,证人	n. 
witty	机智的，风趣的	adj. 
woe	悲痛，苦恼	n. 
wolf	狼	n. 
woman	妇女，女人	n. 
wonder	想知道,诧异	v. 
wonderful	奇妙的，精彩的	adj. 
wood	木，木材	n. 
wooden	木制的	adj. 
woodpecker	啄木鸟	n. 
woods	树林	n. 
wool	羊毛，毛线	n. 
woollen	羊毛的，毛织的	adj. 
word	字，词，诺言，音讯	n. 
wording	措辞	n. 
wordy	冗长的，罗嗦的	adj. 
work	劳动，工作，作品	n. 
workable	可行的，起作用的	adj. 
worker	工人	n. 
workman	工作者	n. 
workmanship	工艺，手艺	n. 
works	工厂	n. 
workshop	车间，工场，学习班	n. 
world	世界，...界，世间	n. 
worldwide	全世界的	adj. adv. 
worm	蠕虫，幼虫	n. 
worry	烦恼，担心	v. v. 
worse	更坏的，更差的	adj. 
worship	崇拜，礼拜	v. n. 
worst	最坏的，最差的	adj. 
worth	价值	n. 
worthless	不值钱的	adj. 
worthwhile	值得做的	adj. 
worthy	值得的，配...的	adj. 
wound	受伤	v. 
wounded	受伤的	adj. 
wrap	包，裹	v. 
wrapper	(饺子)皮，包装用品	n. 
wrath	暴怒	n. 
wreath	花圈，花环	n. 
wreck	毁坏	v. 
wrench	拧，扭伤	v. 
wrestle	摔交，搏斗	v. n. 
wretched	可怜的，可耻的	adj. 
wring	拧，扭	v. 
wrinkle	皱纹	n. 
wrist	腕	n. 
write	写，写信，写作	v. 
writer	作者，作家	n. 
writing	写作	n. 
written	写作的，书面的	adj. 
wrong	错误的，有毛病的	adj. 
wrongly	错误地，不正当地	adv. 
xerox	复印	n. v. 
x-ray	X射线	n. 
yacht	游船，快艇	n. 
yard	码，庭院，场	n. 
yawn	打呵欠	v. n. 
year	年，年度	n. 
yearly	每年的	adj. adv. 
yearn	向往	v. 
yeast	酵母	n. 
yell	叫嚷	v. n. 
yellow	黄色(的)	n. adj. 
yes	是，好	adv. 
yesterday	昨天	n. 
yet	仍然，还，尚	adv. 
yield	生产，屈服	v. 
yoke	轭	n. 
yolk	蛋黄	n. 
you	你，你们	pron. 
young	年轻的	adj. 
youngster	少年	n. 
your	你的，你们的	pron. 
yourself	你(们)自己	pron. 
youth	青春，青年	n. 
youthful	年轻的	adj. 
zeal	热情，热忱	n. 
zealous	热情的，热心的	adj. 
zebra	斑马	n. 
zero	零，零度	n. 
zinc	锌	n. 
zip	活动，尖啸声	n. 
zipcode	邮政编码	n. 
zipper	拉链	n. 
zone	地带，区域，区	n. 
zoo	动物园	n. 
zoology	动物学	n. 
